您现在使用的中文变体可能会影响一些词语繁简转换的效果。建议您根据您的偏好切换到下列变体之一：大陆简体、香港繁體、澳門繁體、大马简体、新加坡简体、臺灣正體。（不再提示 | 了解更多）
新竹維基媒體社群寫作聚會於每個月第一個週末舉辦，歡迎報名參與。
[关闭]
足球比赛
维基百科，自由的百科全书
跳到导航跳到搜索
足球比赛是两支足球队之间根据足球比赛规则所进行的比赛。


目录
1	国际赛事
2	俱乐部足球联赛
3	足球賽事列表
3.1	FIFA（國際性賽事）
3.2	UEFA（歐洲區賽事）
3.3	AFC（亞洲區賽事）
3.4	CONMEBOL （南美洲區賽事）
3.5	CONCACAF （北美洲、中美洲及加勒比海地區賽事）
3.6	OFC （大洋洲區賽事）
3.7	CAF （非洲區賽事）
4	備註
5	参看
国际赛事
各种足球比赛里，最有影响力的是世界杯足球赛，每四年举办一届，1930年由乌拉圭开始举办第一届，因为二战停办了两届，从1950年开始到现在一直没有间断过。成绩最好的是参赛次数最多（共18次）的国家队巴西国家足球队共五次冠军，2006年世界杯足球赛的冠军意大利国家足球队，共获得四次冠军，而德国国家足球队共获得四次冠军，阿根廷、乌拉圭、法国各获得两次冠军，英国、西班牙各一次。

其他的国际性赛事如奥运会足球比赛则是奥林匹克运动会的比赛项目中资格最老的项目之一。各洲内的国际比赛则以欧洲足球锦标赛的水平最高，影响最大。

俱乐部足球联赛
很多国家每年在本国内还有各种足球俱乐部之间的足球联赛。其中意大利足球甲级联赛由于开办时间久，有上百年历史，球队引进“外援”（外国球员）没有较多的限制，从而吸引了各国顶级球员加盟，有“小世界杯”之称。俱乐部对阵最为精彩的要属“同城德比”，在同一座城市下，有两支不同球队竞争，比赛的激烈程度非常高。著名的有米兰德比（AC米兰与国际米兰）

此外，各国俱乐部之间也有比赛，當中歐洲聯賽冠軍盃被視為世界上最高質素的俱樂部賽事，成為歐洲多支頂級球會爭逐的重要錦標，冠軍隊伍可以參加在年尾舉行的的世界俱乐部冠军杯。

世界知名的足球俱乐部如歐洲的阿賈克斯、PSV埃因霍溫、飛燕諾、尤文图斯、曼联、巴塞隆納、皇家马德里及拜仁慕尼黑，乃至南美洲的聖保羅、哥連泰斯、小保加及河床，这些歷史悠久的球队往往在本土聯賽及洲際賽事总是一支独秀，不过近年来这些球队也经受着新秀的冲击如AZ阿爾克馬爾、波圖、切尔西、瓦伦西亚。

现在一般联赛都采用“三分制”，即赢一场比赛得3分，平一场比赛得1分，负不得分。原先是胜一场得2分，现在改革为“鼓励进攻”机制，这样做是为了增强足球的观赏性，增加比赛的激烈程度。

足球賽事列表

国际足联由六個地區性足球協會组成，他们分别是：
     亚洲 — 亞洲足球联合会（AFC）
     非洲 — 非洲足球協會（CAF）
     南美洲 — 南美洲足球協會（CONMEBOL）
     中北美洲及加勒比海地区 — 中北美洲及加勒比海足球協會（CONCACAF）
     大洋洲 — 大洋洲足球協會（OFC）
     歐洲 — 歐洲足球協會（UEFA）

FIFA（國際性賽事）
各顏色標籤代表：
  成年男子賽事
  青年男子賽事
  成年女子賽事
  青年女子賽事
  室內足球賽事
  沙灘足球賽事
已停辦賽事
國家隊賽事

FIFA Logo (2010).svg FIFA官方賽事
賽事中文名稱	賽事官方名稱	賽事簡介
  國際足協世界盃	FIFA World Cup	於1930年舉行首屆賽事，每四年舉辦一屆，亦是世界足壇規模最大、水準最高的賽事。
  國際足協世界盃外圍賽	FIFA World Cup qualification	於1934年舉行首屆賽事，每四年舉辦一屆。
  国际足联联合会杯足球赛	FIFA Confederations Cup	於1992年舉行首屆賽事，每四年舉辦一屆，參賽隊伍包括六大洲國家盃冠軍隊，應屆世界盃冠軍及主辦國共八支球隊。
  國際足協U20世界盃	FIFA U-20 World Cup	於1977年舉行首屆賽事，每兩年舉辦一屆，參賽球員年齡不得超過20歲。
  國際足協U17世界盃	FIFA U-17 World Championship	於1985年舉行首屆賽事，每兩年舉辦一屆，參賽球員年齡不得超過17歲。
  國際足協女子世界盃	FIFA Women's World Cup	於1991年舉行首屆賽事，每四年舉辦一屆，亦是女子足壇規模最大、水準最高的賽事。
  國際足協U20女子世界盃	FIFA U-20 Women's World Championship	於2002年舉行首屆賽事，每兩年舉辦一屆，參賽球員年齡不得超過20歲。
  國際足協U17女子世界盃	FIFA U-17 Women's World Cup	於2008年舉行首屆賽事，每兩年舉辦一屆，參賽球員年齡不得超過17歲。
  國際足協室内五人足球世界盃	FIFA Futsal World Cup	於1989年舉行首屆賽事，每四年舉辦一屆。
  國際足協沙灘足球世界盃	FIFA Beach Soccer World Cup	於1995年舉行首屆賽事，每兩年舉辦一屆。
非FIFA官方賽事
  夏季奧林匹克運動會足球比賽	Summer Olympic Games	1900年正式將足球列入夏季奧運會比賽項目並舉行首屆賽事。參賽球員年齡不得超過23歲，只允許不超過3名年齡23歲以上的運動員參加。1996年奧運會加入女子足球項目。由於國際奧委會不承認英倫三島四個地區獨立的足球管理機構，因此英格蘭、蘇格蘭、北愛爾蘭及威爾士都不能參加有關賽事，只可以組成英國隊參賽。
  夏季世界大學生運動會足球比賽	Summer Universiade	1979年開始成為夏季世界大學生運動會的比賽項目並舉行首屆賽事。參賽球員需為大學生或應屆畢業生。1993年世界大學生運動會加入女子足球項目。英國大學隊上陣次數遠較國奧隊多。
  夏季青年奧林匹克運動會足球比賽	Summer Youth Olympic Games	2010年將足球列入夏季青年奧運會比賽項目並舉行首屆賽事。參賽球員年齡不得超過15歲，賽事設有女子足球項目。
  子午線盃	UEFA-CAF Meridian Cup	曾經於1997年至2005年舉辦，每兩年舉辦一屆，是由歐洲足協和l非洲足協共同舉辦的足球錦標賽，參賽球員年齡不得超過18歲。
阿拉伯世界
  阿拉伯國家盃	Arab Cup of Nations	於1963年舉行首屆賽事，不定期地舉辦，參賽球隊為阿拉伯地區的國家，分別來自亞洲和非洲。
  泛阿拉伯運動會足球比賽	Pan Arab Games	於1953年將足球列入泛阿拉伯運動會比賽項目並舉行首屆賽事。
  海灣國家盃	Gulf Cup of Nations	於1970年舉行首屆賽事，不定期地舉辦，參賽球隊為波斯灣地區國家。
  巴勒斯坦國家盃	Palestine Cup of Nations	曾經於1972年至1977年舉辦，每兩年舉辦一屆，參賽球隊為阿拉伯地區的國家，分別來自亞洲和非洲。
球會賽事

FIFA Logo (2010).svg FIFA官方賽事
賽事中文名稱	賽事官方名稱	賽事簡介
  世界俱乐部冠军杯	FIFA Club World Championship	於2000年舉行首屆賽事，每年舉辦一屆，舉辦地點為歐洲及南美洲之外的國家。
FIFA非官方賽事
  骏河银行锦标赛	Suruga Bank Championship	於2008年舉行首屆賽事，每年舉辦一屆，是由南美足協和日本足協共同舉辦的足球錦標賽，由上年度的南美杯冠軍對陣日本聯賽杯冠軍。
  泛太平洋锦标赛	Pan-Pacific Championship	曾經於2008年及2009年舉辦兩屆，，是由亞洲和美國共同舉辦的足球錦標賽。
  洲際盃	Intercontinental Cup	又稱豐田盃（Toyota Cup），曾經於1980年至2004年舉辦，每年舉辦一屆，是歐聯冠軍和南美自由盃冠軍的對抗賽。
阿拉伯世界
  阿拉伯足協盃	UAFA Club Cup	於1982年舉行首屆賽事，每年舉辦一屆，是阿拉伯地區參與的球會錦標賽。
  海灣聯賽冠軍盃	GCC Champions League	於1982年舉行首屆賽事，每年舉辦一屆，是阿拉伯半島國家參與的球會錦標賽。
  阿拉伯盃賽冠軍盃	Arab Cup Winners' Cup	曾經於1989年至2001年舉辦，每年舉辦一屆，是阿拉伯地區國內盃賽冠軍參與的球會錦標賽。2002年起，賽事被阿拉伯足協盃取代。
  阿拉伯超級盃	Arab Super Cup	曾經於1992年至2001年舉辦，每年舉辦一屆，是阿拉伯足協盃冠軍和阿拉伯盃賽冠軍盃冠軍的對抗賽。
UEFA（歐洲區賽事）
UEFA member associations map.svg
阿爾巴尼亞 | 安道爾 | 亞美尼亞 | 奧地利 | 阿塞拜疆 | 白俄羅斯 | 比利時 | 波斯尼亞和黑塞哥維那 | 保加利亞 | 克羅地亞 | 塞浦路斯 |
捷克 | 丹麥 | 英格蘭 | 愛沙尼亞 | 法羅群島 | 芬蘭 | 法國 | 格魯吉亞 | 德國 | 直布羅陀 | 希臘 | 匈牙利 | 冰島 | 愛爾蘭 | 以色列 | 意大利 | 哈薩克 |
拉脫維亞 | 列支敦士登 | 立陶宛 | 盧森堡 | 馬其頓 | 馬爾他 | 摩爾多瓦 | 黑山 | 荷蘭 | 北愛爾蘭 | 挪威 | 波蘭 | 葡萄牙 | 羅馬尼亞 |
俄羅斯 | 聖馬力諾 | 蘇格蘭 | 塞爾維亞 | 斯洛伐克 | 斯洛文尼亞 | 西班牙 | 瑞典 | 瑞士 | 土耳其 | 烏克蘭 | 威爾斯
國家隊賽事

UEFA官方賽事
賽事中文名稱	賽事官方名稱	賽事簡介
  欧洲足球锦标赛	UEFA European Championship	於1960年舉行首屆賽事，每四年舉辦一屆，亦是歐洲足壇規模最大、水準最高的國家隊賽事。
  歐洲足協國家聯賽	UEFA Nations League	於2018年舉行首屆賽事，每兩年舉辦一屆。
  歐洲國家盃外圍賽	UEFA European Championship qualifying	於1960年舉行首屆賽事，每四年舉辦一屆。
  歐洲U21足球錦標賽	UEFA European U-21 Football Championship	於1978年舉行首屆賽事，每四年舉辦一屆，參賽球員年齡不得超過21歲。
  歐洲U19足球錦標賽	UEFA European U-19 Football Championship	於1948年舉行首屆賽事，每年舉辦一屆，參賽球員年齡不得超過19歲，亦是世青盃歐洲區預賽。
  歐洲U17足球錦標賽	UEFA European U-17 Football Championship	於1982年舉行首屆賽事，每年舉辦一屆，參賽球員年齡不得超過17歲，亦是世少盃歐洲區預賽。
  欧洲女子足球锦标赛	UEFA Women's Championship	於1982年舉行首屆賽事，每四年舉辦一屆。
  歐洲U19女子錦標賽	UEFA Women U-19 Football Championship	於1997年舉行首屆賽事，每年舉辦一屆，參賽球員年齡不得超過19歲。
  歐洲U17女子錦標賽	UEFA Women U-17 Football Championship	於2007年舉行首屆賽事，每年舉辦一屆，參賽球員年齡不得超過17歲。
  歐洲室內五人足球錦標賽	UEFA Futsal Championship	於1996年舉行首屆賽事，每兩年舉辦一屆。
  沙灘足球世界盃歐洲區預賽	UEFA Beach Soccer World Cup qualification	於2008年舉行首屆賽事，每兩年舉辦一屆。
  歐洲沙灘足球聯賽	Euro Beach Soccer League	於1998年舉行首屆賽事，每年舉辦一屆。
  歐洲區域盃	UEFA Regions' Cup	於1996年舉行首屆賽事，每兩年舉辦一屆，是一項由半職業及業餘球隊參與的錦標賽。
UEFA非官方賽事
  凱爾特國家杯	4 Associations' Tournament	於2011年舉行首屆賽事，每兩年舉辦一屆，是由愛爾蘭共和國，北愛爾蘭，蘇格蘭和威爾斯參與的錦標賽。
  英國本土四角錦標賽	British Home Championship	曾經於1883年至1984年舉辦，由英格蘭、蘇格蘭、威爾斯及北愛爾蘭參與的錦標賽。
  巴爾幹半島盃	Balkan Cup	曾經於1929年至1980年舉辦，不定期舉辦，是巴爾幹半島地區的國家參加的錦標賽。
  中歐國際盃	Central European International Cup	曾經於1927年至1960年舉辦，不定期舉辦，是中歐地區的國家參加的錦標賽。
球會賽事

UEFA官方賽事
賽事中文名稱	賽事官方名稱	賽事簡介
  歐洲聯賽冠軍盃	UEFA Champions League	於1955年舉行首屆賽事，每年舉辦一屆，亦是歐洲足壇規模最大、水準最高的球會賽事。
  歐霸盃	UEFA Europa League	於2009年舉行首屆賽事，每年舉辦一屆，歐洲足協盃為它的前身。
  歐洲超級盃	UEFA Super Cup	於1972年舉行首屆賽事，每年舉辦一屆，1999年前由歐洲盃賽冠軍盃冠軍與歐洲聯賽冠軍盃冠軍爭奪錦標，現在由歐霸盃冠軍與歐聯冠軍角逐殊榮，1998年開始定於摩納哥進行。
  歐洲青年聯賽	UEFA Youth League	於2013年舉行首屆賽事，每年舉辦一屆，為歐洲聯賽冠軍盃的青年版球賽。
  歐洲女子冠軍聯賽	UEFA Women's Champions League	於2001年舉行首屆賽事，每年舉辦一屆。
  歐洲室內足球盃	UEFA Futsal Cup	於2001年舉行首屆賽事，每年舉辦一屆。
  歐洲足協圖圖盃	UEFA Intertoto Cup	曾經於1995年至2009年舉辦，每年舉辦一屆，是一項供未能取得主要歐洲足球比賽（歐冠或足協杯）參賽席位的歐洲球會參加的錦標賽。
  欧洲优胜者杯	UEFA Cup Winners' Cup	曾經於1960年至1999年舉辦，每年舉辦一屆。
  歐洲足協盃	UEFA Cup	曾經於1971年至2009年舉辦，每年舉辦一屆，2009年已改制成為歐霸盃。
UEFA非官方賽事
  塞坦塔體育頻道盃	Setanta Sports Cup	於2005年舉行首屆賽事，每年舉辦一屆，是由 爱尔兰及 北爱尔兰國內聯賽冠亞軍及國內盃賽冠軍參加的球會錦標賽。
  巴爾幹半島球會盃	Balkans Cup	曾經於1961年至1994年舉辦，每年舉辦一屆，是巴爾幹半島地區的國家參加的球會錦標賽。
  波羅的海盃	Baltic League	曾經於2007年至2011年舉辦，每年舉辦一屆，是由愛沙尼亞，立陶宛和拉脫維亞國內聯賽首四名參與的球會錦標賽。
  城市博覽會盃	Inter-Cities Fairs Cup	曾經於1957年至1971年舉辦，每年舉辦一屆，歐洲足協盃的前身。
  拉丁盃	Latin Cup	曾經於1949年至1957年舉辦，每年舉辦一屆，是由法國、義大利、西班牙及葡萄牙國內聯賽冠軍球會參加的錦標賽。
  利伏尼亞盃	Livonia Cup	曾經於2003年至2011年舉辦，不定期舉辦，是由愛沙尼亞及拉脫維亞國內聯賽冠軍球會對抗的錦標賽。
  米杜柏杯	Mitropa Cup	曾經於1927年至1992年舉辦，每年舉辦一屆，是中歐地區國家參加的球會錦標賽。
  皇家联赛	Royal League	曾經於2004年至2007年舉辦，每年舉辦一屆，是由 丹麥， 挪威及 瑞典國內聯賽首四名參與的球會錦標賽。
  德士古盃	Texaco Cup	曾經於1971年至1975年舉辦，每年舉辦一屆，是英格蘭及愛爾蘭球會參加的足球錦標賽。
  英蘇盃	Anglo-Scottish Cup	曾經於1976年至1981年舉辦，每年舉辦一屆，是英格蘭及蘇格蘭球會參加的足球錦標賽。
  英義盃	Anglo-Italian Cup	曾經於1970年至1996年舉辦，每年舉辦一屆，是英格蘭及意大利球會參加的足球錦標賽。
  英義聯賽盃	Anglo-Italian League Cup	曾經於1969年至1976年舉辦，每年舉辦一屆，是英格蘭聯賽盃或足總盃與意大利盃的冠軍對抗賽。
阿尔巴尼亚 阿爾巴尼亞
賽事中文名稱	賽事官方名稱	賽事性質	賽事簡介
  阿爾巴尼亞超級足球聯賽	Kategoria Superiore	國內頂級聯賽	於1930年舉行首屆賽事。
  阿爾巴尼亞甲組足球聯賽	Kategoria e Parë	國內第二級聯賽	於1930年舉行首屆賽事。
  阿爾巴尼亞盃	Kupa e Shqipërisë	全國性盃賽	於1939年舉行首屆賽事。
  阿爾巴尼亞超級盃	Albanian Supercup	超級盃	於1989年舉行首屆賽事。
安道尔 安道爾
賽事中文名稱	賽事官方名稱	賽事性質	賽事簡介
  安道尔足球甲级联赛	Primera Divisió	國內頂級聯賽	於1995年舉行首屆賽事。
  安道尔足球乙级联赛	Segona Divisió	國內二級聯賽	於1999年舉行首屆賽事。
  安道爾杯	Copa Constitució	全國性盃賽	於1990年舉行首屆賽事。
亞美尼亞 亞美尼亞
賽事中文名稱	賽事官方名稱	賽事性質	賽事簡介
  亚美尼亚足球甲级联赛	Armenian Premier League	國內頂級聯賽	於1992年舉行首屆賽事。
  亞美尼亞獨立盃	Armenian Independence Cup	全國性盃賽	於1939年舉行首屆賽事。
  亚美尼亚超级杯	Armenian Supercup	超級盃	於1997年舉行首屆賽事。
奥地利 奧地利
賽事中文名稱	賽事官方名稱	賽事性質	賽事簡介
  奥地利足球超级联赛	Austrian Football Bundesliga	國內頂級聯賽	於1974年舉行首屆賽事。
  奥地利足球甲级联赛	Austrian Football First League	國內第二級聯賽	於1974年舉行首屆賽事。
  奧地利東部地區聯賽	Austrian Regional League East	國內第三級聯賽	於1984年舉行首屆賽事。
  奧地利中部地區聯賽	Austrian Regional League Central	國內第三級聯賽	於1994年舉行首屆賽事。
  奧地利西部地區聯賽	Austrian Regional League West	國內第三級聯賽	於1981年舉行首屆賽事。
  奧地利業餘足球聯賽（布尔根兰邦）	Landesliga Burgenland	國內第四級聯賽	聯賽冠軍可以升上奧地利東部地區聯賽。
  奧地利業餘足球聯賽（下奧地利邦）	1. Niederösterreichische Landesliga
  奧地利業餘足球聯賽（維也納邦）	Wiener Stadtliga
  奧地利業餘足球聯賽（克恩顿州及蒂羅爾邦）	Kärntner Liga	聯賽冠軍可以升上奧地利中部地區聯賽。
  奧地利業餘足球聯賽（上奧地利邦）	Oberösterreich-Liga
  奧地利業餘足球聯賽（施泰爾馬克邦）	Landesliga Steiermark
  奧地利業餘足球聯賽（薩爾斯堡邦）	1. Salzburger Landesliga	聯賽冠軍可以升上奧地利西部地區聯賽。
  奧地利業餘足球聯賽（蒂羅爾邦）	Tiroler Liga
  奧地利業餘足球聯賽（福拉爾貝格邦）	Vorarlbergliga
  奧地利盃	Austrian Cup	全國性盃賽	於1919年舉行首屆賽事。
  奧地利超級盃	Austrian Supercup	超級盃	於1986年舉行首屆賽事。
阿塞拜疆 阿塞拜疆
賽事中文名稱	賽事官方名稱	賽事性質	賽事簡介
  阿塞拜疆足球甲级联赛	Azerbaijan Premier League	國內頂級聯賽	於1992年舉行首屆賽事。
  阿塞拜疆杯	Azerbaijan Cup	全國性盃賽	於1936年舉行首屆賽事。
白俄罗斯 白俄羅斯
賽事中文名稱	賽事官方名稱	賽事性質	賽事簡介
  白俄羅斯足球超級聯賽	Вышэйшая ліга	國內頂級聯賽	於1992年舉行首屆賽事。
  白俄羅斯杯	Кубак Беларусі	全國性盃賽	於1992年舉行首屆賽事。
比利时 比利時
賽事中文名稱	賽事官方名稱	賽事性質	賽事簡介
  比利時甲級足球聯賽	Belgian Pro League	國內頂級聯賽	於1895年舉行首屆賽事。
  比利时足球乙级联赛	Belgian Second Division	國內第二級聯賽	於1905年舉行首屆賽事。
  比利时杯	Belgian Cup	全國性盃賽	於1911年舉行首屆賽事。
  比利时超级杯	Belgian Super Cup	超級盃	於1979年舉行首屆賽事。
波斯尼亚和黑塞哥维那 波斯尼亞和黑塞哥維那
賽事中文名稱	賽事官方名稱	賽事性質	賽事簡介
  波黑超級足球聯賽	Premijer liga Bosne i Hercegovine	國內頂級聯賽	於2000年舉行首屆賽事。
保加利亚 保加利亞
賽事中文名稱	賽事官方名稱	賽事性質	賽事簡介
  保加利亞足球甲級聯賽	"А" Футболна Група	國內頂級聯賽	於1924年舉行首屆賽事。
  保加利亞足球乙級聯賽	"Б" Футболна Група	國內第二級聯賽	於1950年舉行首屆賽事。
  保加利亞盃	Купа на България	全國性盃賽	於1938年舉行首屆賽事。
克罗地亚 克羅地亞
賽事中文名稱	賽事官方名稱	賽事性質	賽事簡介
  克罗地亚足球甲级联赛	Prva hrvatska nogometna liga	國內頂級聯賽	於1992年舉行首屆賽事。
賽普勒斯 塞浦路斯
賽事中文名稱	賽事官方名稱	賽事性質	賽事簡介
  塞浦路斯甲組足球聯賽	Πρωτάθλημα Α' Κατηγορίας	國內頂級聯賽	於1934年舉行首屆賽事。
  塞浦路斯乙組足球聯賽	Πρωτάθλημα Β΄ Κατηγορίας	國內第二級聯賽	於1953年舉行首屆賽事。
  塞浦路斯杯	Κύπελλο Κύπρου	全國性盃賽	於1934年舉行首屆賽事。
  塞浦路斯超级杯	Cypriot Super Cup	超級盃	於1951年舉行首屆賽事。
捷克 捷克
賽事中文名稱	賽事官方名稱	賽事性質	賽事簡介
  捷克足球甲级联赛	Gambrinus liga	國內頂級聯賽	於1993年舉行首屆賽事。
  捷克杯	Pohár České pošty	全國性盃賽	於1993年舉行首屆賽事。
丹麦 丹麥
賽事中文名稱	賽事官方名稱	賽事性質	賽事簡介
  丹麥足球超級聯賽	Superligaen	國內頂級聯賽	於1991年舉行首屆賽事。
  丹麦足球甲级联赛	Danish 1st Division	國內第二級聯賽	於1945年舉行首屆賽事。
  丹麦杯	DBU Pokalen	全國性盃賽	於1955年舉行首屆賽事。
英格兰 英格蘭
國內聯賽

賽事中文名稱	賽事官方名稱	賽事性質	賽事簡介
  英格兰足球超级联赛	Premier League	國內頂級聯賽	於1992年舉行首屆賽事。
  英格蘭足球冠軍聯賽	Football League Championship	國內第二級聯賽	於2004年舉行首屆賽事，英格蘭足球聯賽最高級別聯賽。
  英格蘭足球甲級聯賽	Football League One	國內第三級聯賽	於2004年舉行首屆賽事，英格蘭足球聯賽第二級別聯賽。
  英格蘭足球乙級聯賽	Football League Two	國內第四級聯賽	於2004年舉行首屆賽事，英格蘭足球聯賽第三級別聯賽。
  英格蘭足球協會全國聯賽	Football Conference National	國內第五級聯賽	於1979年舉行首屆賽事。
  英格蘭足球議會北部聯賽	Football Conference North	國內第六級聯賽	於2004年舉行首屆賽事。
  英格蘭足球議會南部聯賽	Football Conference South	國內第六級聯賽	於2004年舉行首屆賽事。
  英格蘭北部超聯超聯組	Northern Premier League Premier Division	國內第七級聯賽	於1968年舉行首屆賽事。
  英格蘭南部聯賽超聯組	Southern Football League Premier Division	國內第七級聯賽	於2009年舉行首屆賽事。
  英格蘭依斯米安聯賽超聯組	Isthmian League Premier Division	國內第七級聯賽	於1905年舉行首屆賽事。
  英格蘭北部超聯甲組（北部）	Northern Premier League Division One North	國內第八級聯賽	於2007年舉行首屆賽事。
  英格蘭北部超聯甲組（南部）	Northern Premier League Division One South	國內第八級聯賽	於2007年舉行首屆賽事。
  英格蘭南部聯賽甲組（中部）	Southern Football League Division One Central	國內第八級聯賽	於2009年舉行首屆賽事。
  英格蘭南部聯賽甲組（西南部）	Southern Football League Division One South & West	國內第八級聯賽	於2009年舉行首屆賽事。
  英格蘭依斯米安聯賽甲組（北部）	Isthmian League Division One North	國內第八級聯賽	於2006年舉行首屆賽事。
  英格蘭依斯米安聯賽甲組（南部）	Isthmian League Division One South	國內第八級聯賽	於2006年舉行首屆賽事。
國內第九級聯賽
賽事中文名稱	賽事官方名稱	賽事簡介
  聯合郡制足球聯賽超聯組	Combined Counties League Premier Division	於1978年舉行首屆賽事，參賽球隊來自薩里郡、伯克郡、漢普郡及大倫敦西南部。
  東部郡制足球聯賽超聯組	Eastern Counties Football League Premier Division	於1935年舉行首屆賽事，參賽球隊來自诺福克郡、薩福克郡、雅息士郡北部及劍橋郡東部。
  艾塞克斯郡高級足球聯賽	Essex Senior Football League	於1971年舉行首屆賽事，參賽球隊來自埃塞克斯郡、赫特福德郡東部及大倫敦西南部。
  海倫尼克足球聯賽超聯組	Hellenic Football League Premier Division	於1953年舉行首屆賽事，參賽球隊來自伯克郡、格洛斯特郡、牛津郡、白金汉郡南部及赫里福德郡南部。
  中部足球聯盟	Midland Football Alliance	於1994年舉行首屆賽事，參賽球隊來自莱斯特郡、什罗普郡、斯塔福德郡、沃里克郡、西米德蘭茲郡、伍斯特郡、德比郡南部及諾丁漢郡南部。
  北部東郡制足球聯賽超聯組	Northern Counties East Football League Premier Division	於1982年舉行首屆賽事，參賽球隊來自北約克郡東南部、東約克郡、林肯郡北部、南約克郡、西約克郡、諾丁漢郡北部。
  北部甲組足球聯賽	Northern League Division One	於1889年舉行首屆賽事，參賽球隊來自達勒姆郡、諾森伯蘭郡、泰恩-威爾郡、坎布里亞郡北部及北约克郡北部。
  西北郡制甲組足球聯賽超聯組	North West Counties Football League Premier Division	於1982年舉行首屆賽事，參賽球隊來自柴郡、大曼徹斯特郡、兰开夏郡、默西賽德郡、[坎布里亞郡]]南部、斯塔福德郡北部、德比郡北部及西约克郡西部。
  東部南郡制足球聯賽	Southern Counties East League	於1966年舉行首屆賽事，
  斯巴達中部南足球聯賽超聯組	Spartan South Midlands Football League Premier Division	於1997年舉行首屆賽事，
  薩西克斯郡甲組足球聯賽	Sussex County Football League Division One	於1920年舉行首屆賽事，
  聯合郡制足球聯賽超聯組	United Counties Football League Premier Division	於1934年舉行首屆賽事，
  威塞克斯足球聯賽超聯組	Wessex League Premier Division	於1986年舉行首屆賽事，
  西部足球聯賽超聯組	Western League Premier Division	於1892年舉行首屆賽事，
國內盃賽

賽事中文名稱	賽事官方名稱	賽事性質	賽事簡介
  英格蘭慈善盾	Community Shield	超級盃	於1908年舉行首屆賽事，是由英格兰足總杯冠軍及英超聯冠軍對抗的錦標賽。
  英格兰足總杯	FA Cup	全國性盃賽	於1872年舉行首屆賽事。
  英格兰聯赛杯	Football League Cup	聯賽盃	於1961年舉行首屆賽事。
  英格蘭聯賽錦標	Football League Trophy	低組別盃賽	於1983年舉行首屆賽事，是由甲級聯賽及乙級聯賽成員角逐的錦標賽。
  英格蘭足總錦標	FA Trophy	低組別盃賽	於1970年舉行首屆賽事，是由國內聯賽系統第五級至第八級聯賽成員角逐的錦標賽。
  英格蘭足總挑戰瓶	FA Vase	低組別盃賽	於1974年舉行首屆賽事，是由國內聯賽系統第九級聯賽及低組別地區聯賽成員角逐的錦標賽。
  英格蘭國際聯賽盃	FA Inter-League Cup	低組別盃賽	於1974年舉行首屆賽事，是由國內聯賽系統第十一級聯賽及低組別地區聯賽成員角逐的錦標賽。
  英格蘭足球議會聯賽盃	The Conference League Cup	低組別盃賽	於1979年舉行首屆賽事。
  酋長盃	Emirates Cup	季前熱身賽	於2007年舉行首屆賽事，是由阿仙奴於每年賽季前舉辦的熱身賽。
  英格蘭女子足球超級聯賽	FA Women's Premier League	女子國內頂級聯賽	於1992年舉行首屆賽事。
  英格蘭女子足總盃	FA Women's Cup	女子全國性盃賽	於1971年舉行首屆賽事。
  英格蘭女子聯賽盃	FA Women's Premier League Cup	女子聯賽盃	於1991年舉行首屆賽事，只有英格蘭女子足球超級聯賽球隊參加。
  英格蘭女子慈善盾	FA Women's Community Shield	女子超級盃	於2000年舉行首屆賽事，是由英格蘭女子足總盃冠軍及女子英超聯冠軍對抗的錦標賽。
爱沙尼亚 愛沙尼亞
賽事中文名稱	賽事官方名稱	賽事性質	賽事簡介
  爱沙尼亚足球甲级联赛	Meistriliiga	國內頂級聯賽	於1992年舉行首屆賽事。
  爱沙尼亚足球乙级联赛	Esiliiga	國內第二級聯賽	於1992年舉行首屆賽事。
法罗群岛 法羅群島
賽事中文名稱	賽事官方名稱	賽事性質	賽事簡介
  法羅群島足球超級聯賽	Faroe Islands Premier League	國內頂級聯賽	於1942年舉行首屆賽事。
  法罗群岛足球甲级联赛	Faroe Islands 1. Division、1. deild	國內第二級聯賽	於1943年舉行首屆賽事。
芬兰 芬蘭
賽事中文名稱	賽事官方名稱	賽事性質	賽事簡介
  芬蘭足球超級聯賽	Veikkausliiga	國內頂級聯賽	於1990年舉行首屆賽事。
  芬兰足球甲级联赛	Ykkönen	國內第二級聯賽	於1995年舉行首屆賽事。
  芬兰杯	Suomen Cup	全國性盃賽	於1955年舉行首屆賽事。
  芬兰联赛杯	Finnish League Cup	聯賽盃	於1994年舉行首屆賽事。
法國 法國
賽事中文名稱	賽事官方名稱	賽事性質	賽事簡介
  法國足球甲級聯賽	Ligue 1	國內頂級聯賽	於1932年舉行首屆賽事。
  法國足球乙級聯賽	Ligue 2	國內第二級聯賽	於1933年舉行首屆賽事。
  法國足球丙級聯賽	Ligue 3	國內第三級聯賽	於1993年舉行首屆賽事。
  法國業餘甲組足球聯賽	Championnat de France amateur	國內第四級聯賽	於1993年舉行首屆賽事，聯賽分為四個組別。
  法國業餘乙組足球聯賽	Championnat de France amateur 2	國內第五級聯賽	於1993年舉行首屆賽事，聯賽分為八個組別。
  亞爾薩斯榮譽足球聯賽	Division Honneur Alsace	國內第六級聯賽	亞爾薩斯地區最高級別聯賽。
  亞奎丹榮譽足球聯賽	Division Honneur Aquitaine	國內第六級聯賽	亞奎丹地區最高級別聯賽。
  大西洋榮譽足球聯賽	Division Honneur Atlantique	國內第六級聯賽	大西洋卢瓦尔省，曼恩-卢瓦尔省及旺代省地區最高級別聯賽。
  奧文尼榮譽足球聯賽	Division Honneur Auvergne	國內第六級聯賽	奧文尼地區最高級別聯賽。
  下诺曼底榮譽足球聯賽	Division Honneur Basse-Normandy	國內第六級聯賽	下诺曼底地區最高級別聯賽。
  勃艮第榮譽足球聯賽	Honneur Ligue Bourgogne	國內第六級聯賽	勃艮第地區最高級別聯賽。
  布列塔尼榮譽足球聯賽	Division Honneur Bretagne	國內第六級聯賽	布列塔尼地區最高級別聯賽。
  中央榮譽足球聯賽	Division Honneur Centre	國內第六級聯賽	中央地區最高級別聯賽。
  香槟-阿登榮譽足球聯賽	Division Honneur Champagne-Ardenne	國內第六級聯賽	香槟-阿登地區最高級別聯賽。
  中西區榮譽足球聯賽	Division Honneur Centre-Ouest	國內第六級聯賽	利穆赞及普瓦图-夏朗德地區最高級別聯賽。
  科西嘉榮譽足球聯賽	Division Honneur Corse	國內第六級聯賽	科西嘉岛地區最高級別聯賽。
  弗朗什-孔泰榮譽足球聯賽	Division Honneur Franche-Comté	國內第六級聯賽	弗朗什-孔泰地區最高級別聯賽。
  朗格多克-鲁西永榮譽足球聯賽	Division Honneur Languedoc-Roussillon	國內第六級聯賽	朗格多克-鲁西永地區最高級別聯賽。
  洛林榮譽足球聯賽	Division Honneur Lorraine	國內第六級聯賽	洛林地區最高級別聯賽。
  緬因榮譽足球聯賽	Division Honneur Maine	國內第六級聯賽	马耶讷省及萨尔特省地區最高級別聯賽。
  地中海榮譽足球聯賽	Division Honneur Méditerranée	國內第六級聯賽	普罗旺斯-阿尔卑斯-蓝色海岸地區最高級別聯賽。
  諾曼第榮譽足球聯賽	Division Honneur Normandie	國內第六級聯賽	上諾曼地地區最高級別聯賽。
  北部-加来海峡榮譽足球聯賽	Division Honneur Nord-Pas-de-Calais	國內第六級聯賽	北部-加来海峡地區最高級別聯賽。
  巴黎榮譽足球聯賽	Division Honneur Paris Île-de-France	國內第六級聯賽	大巴黎地區地區最高級別聯賽。
  皮卡第榮譽足球聯賽	Division Honneur Picardie	國內第六級聯賽	皮卡第地區最高級別聯賽。
  隆河-阿爾卑斯榮譽足球聯賽	Honneur Ligue Rhône-Alpes	國內第六級聯賽	隆河-阿爾卑斯地區最高級別聯賽。
  法國盃	Coupe de France	全國性盃賽	於1918年舉行首屆賽事。
  法國聯賽盃	Coupe de la Ligue	聯賽盃	於1982年舉行首屆賽事。
  法國超級盃	Trophée des champions	超級盃	於1955年舉行首屆賽事。
格鲁吉亚 格鲁吉亚
賽事中文名稱	賽事官方名稱	賽事性質	賽事簡介
  格鲁吉亚足球超级联赛	პრემიერ ლიგა	國內頂級聯賽	於1990年舉行首屆賽事。
德国 德國
賽事中文名稱	賽事官方名稱	賽事性質	賽事簡介
  德国足球甲级联赛	Fußball-Bundesliga	國內頂級聯賽	於1963年舉行首屆賽事。
  德国足球乙级联赛	2. Fußball-Bundesliga	國內第二級聯賽	於1974年舉行首屆賽事。
  德国足球丙级联赛	3. Fußball-Liga	國內第三級聯賽	於2008年舉行首屆賽事。
  德國足球地區聯賽北區	Fußball-Regionalliga Nord	國內第四級聯賽	於1994年舉行首屆賽事。
  德國足球地區聯賽東北區	Fußball-Regionalliga Nordost	國內第四級聯賽	於1994年舉行首屆賽事。
  德國足球地區聯賽巴伐利亞區	Fußball-Regionalliga Bavaria	國內第四級聯賽	於2012年舉行首屆賽事。
  德國足球地區聯賽西南區	Fußball-Regionalliga Sǖdwest	國內第四級聯賽	於2012年舉行首屆賽事。
  德國足球地區聯賽西區	Fußball-Regionalliga West	國內第四級聯賽	於2008年舉行首屆賽事。
  德國足球高級聯賽巴登-符騰堡區	Fußball-Oberliga Baden-Württemberg	國內第五級聯賽	於1978年舉行首屆賽事。
  德國足球高級聯賽巴伐利亞北區	Fußball-Bayernliga Nord	國內第五級聯賽	於2012年舉行首屆賽事。
  德國足球高級聯賽巴伐利亞南區	Fußball-Bayernliga Süd	國內第五級聯賽	於2012年舉行首屆賽事。
  德國足球高級聯賽不萊梅區	Bremen-Liga	國內第五級聯賽	於1947年舉行首屆賽事。
  德國足球高級聯賽漢堡區	Fußball-Oberliga Hamburg	國內第五級聯賽	於1945年舉行首屆賽事。
  德國足球高級聯賽黑森區	Hessenliga	國內第五級聯賽	於1945年舉行首屆賽事。
  德國足球高級聯賽中莱茵區	Fußball-Oberliga Mittelrhein	國內第五級聯賽	於1956年舉行首屆賽事。
  德國足球高級聯賽下萊茵區	Fußball-Oberliga Niederrhein	國內第五級聯賽	於1956年舉行首屆賽事。
  德國足球高級聯賽下萨克森區	Niedersachsenliga	國內第五級聯賽	於1947年舉行首屆賽事。
  德國足球高級聯賽東北（北區）	NOFV-Oberliga Nord	國內第五級聯賽	於1991年舉行首屆賽事。
  德國足球高級聯賽東北（南區）	NOFV-Oberliga Süd	國內第五級聯賽	於1991年舉行首屆賽事。
  德國足球高級聯賽萊因蘭-法爾茲及薩爾區	Fußball-Oberliga Rheinland-Pfalz/Saar	國內第五級聯賽	於1978年舉行首屆賽事。
  德國足球高級聯賽什列斯威－好斯敦區	Schleswig-Holstein-Liga	國內第五級聯賽	於1947年舉行首屆賽事。
  德國足球高級聯賽威斯特法倫區	Oberliga Westfalen	國內第五級聯賽	於1978年舉行首屆賽事。
  德國盃	DFB-Pokal	全國性盃賽	於1934年舉行首屆賽事。
  德國聯賽盃	DFB-Ligapokal	超級盃	於1997年舉行首屆賽事。
直布罗陀 直布羅陀
賽事中文名稱	賽事官方名稱	賽事性質	賽事簡介
  直布羅陀超級足球聯賽	Gibraltar Premier Division	國內頂級聯賽	於1895年舉行首屆賽事。
  直布羅陀岩石盃	Rock Cup	全國性盃賽	於1894年舉行首屆賽事。
希腊 希臘
賽事中文名稱	賽事官方名稱	賽事性質	賽事簡介
  希腊足球超级联赛	Σούπερ Λίγκα Ελλάδα	國內頂級聯賽	於1927年舉行首屆賽事。
  希臘足球甲級聯賽	Φούτμπολ Λιγκ	國內第二級聯賽	於1959年舉行首屆賽事。
  希腊足球乙级联赛	Φούτμπολ Λιγκ 2	國內第三級聯賽	於1982年舉行首屆賽事。
  希臘盃	Κύπελλο Ελλάδος Ποδοσφαίρου	全國性盃賽	於1931年舉行首屆賽事。
  希腊超级杯	Σούπερ Καπ Ελλάδος	超級盃	於1987年舉行首屆賽事。
匈牙利 匈牙利
賽事中文名稱	賽事官方名稱	賽事性質	賽事簡介
  匈牙利足球甲级联赛	Nemzeti Bajnokság I	國內頂級聯賽	於1901年舉行首屆賽事。
  匈牙利足球乙级联赛	Nemzeti Bajnokság II	國內第二級聯賽	於1955年舉行首屆賽事。
  匈牙利杯	Magyar Kupa	全國性盃賽	於1910年舉行首屆賽事。
  匈牙利聯賽盃	Ligakupa	聯賽盃	於2007年舉行首屆賽事。
  匈牙利超級盃	Szuperkupa	超級盃	於1992年舉行首屆賽事，是由甲組聯賽冠軍及匈牙利杯冠軍對抗的錦標賽。
冰岛 冰島
賽事中文名稱	賽事官方名稱	賽事性質	賽事簡介
  冰島足球超級聯賽	Úrvalsdeild	國內頂級聯賽	於1912年舉行首屆賽事。
愛爾蘭共和國 愛爾蘭
賽事中文名稱	賽事官方名稱	賽事性質	賽事簡介
  FAI愛爾蘭超級足球聯賽	League of Ireland Premier Division	國內頂級聯賽	於1985年舉行首屆賽事。
  愛爾蘭甲組足球聯賽	League of Ireland First Division	國內頂級聯賽	於1985年舉行首屆賽事。
  愛爾蘭足協盃	FAI Cup	全國性盃賽	於1922年舉行首屆賽事。
  愛爾蘭足協聯賽盃	League of Ireland Cup	聯賽盃	於1973年舉行首屆賽事。
以色列 以色列
賽事中文名稱	賽事官方名稱	賽事性質	賽事簡介
  以色列足球超级联赛	Ligat ha'Al	國內頂級聯賽	於1999年舉行首屆賽事。
  以色列國家足球聯賽	Liga Leumit	國內第二級聯賽	於1954年舉行首屆賽事。
義大利 意大利
賽事中文名稱	賽事官方名稱	賽事性質	賽事簡介
  意大利足球甲级联赛	Serie A	國內頂級聯賽	於1898年舉行首屆賽事。
  意大利足球乙级联赛	Serie B	國內第二級聯賽	於1929年舉行首屆賽事。
  意大利足球丙一级联赛	Serie C1	國內第三級聯賽	於2008年舉行首屆賽事。
  意大利足球丙二级联赛	Serie C2	國內第四級聯賽	於2008年舉行首屆賽事。
  意大利足球丁级联赛	Serie D	國內第五級聯賽	於1952年舉行首屆賽事。是意大利非職業聯賽中的最高級別，聯賽分為9個地區組別，每個組別有18-20支隊伍不等。
  意大利足球卓越聯賽	Eccellenza	國內第六級聯賽	聯賽分為28個地區組別。
  意大利足球推广联赛	Promozione	國內第七級聯賽	聯賽分為54個地區組別。
  意大利盃	Coppa Italia	全國性盃賽	於1922年舉行首屆賽事。
  意大利超級盃	Super Coppa Italiana	超級盃	於1988年舉行首屆賽事，是由意甲聯賽冠軍及意大利盃冠軍對抗的錦標賽。
哈萨克斯坦 哈薩克
賽事中文名稱	賽事官方名稱	賽事性質	賽事簡介
  哈薩克超級足球聯賽	Kazakhstan Premier League	國內頂級聯賽	於1992年舉行首屆賽事。
  哈薩克甲組足球聯賽	Kazakhstan First Division	國內頂級聯賽	於1994年舉行首屆賽事。
  哈薩克盃	Kazakhstan Cup	全國性盃賽	於1992年舉行首屆賽事。
  哈薩克超級盃	Kazakhstan Super Cup	超級盃	於2008年舉行首屆賽事，是由哈薩克聯賽冠軍及哈薩克盃冠軍對抗的錦標賽。
拉脫維亞 拉脫維亞
賽事中文名稱	賽事官方名稱	賽事性質	賽事簡介
  拉脫維亞足球高級聯賽	Latvian Higher League	國內頂級聯賽	於1927年舉行首屆賽事。
列支敦斯登 列支敦士登
賽事中文名稱	賽事官方名稱	賽事性質	賽事簡介
  列支敦士登盃	Liechtenstein Cup	全國性盃賽	於1946年舉行首屆賽事。
立陶宛 立陶宛
賽事中文名稱	賽事官方名稱	賽事性質	賽事簡介
  立陶宛足球甲级联赛	A Lyga	國內頂級聯賽	於1991年舉行首屆賽事。
卢森堡 盧森堡
賽事中文名稱	賽事官方名稱	賽事性質	賽事簡介
  盧森堡國家足球聯賽	National Division	國內頂級聯賽	於1910年舉行首屆賽事。
馬其頓共和國 馬其頓
賽事中文名稱	賽事官方名稱	賽事性質	賽事簡介
  馬其頓甲組足球聯賽	Прва македонска Фудбалска Лига	國內頂級聯賽	於1992年舉行首屆賽事。
马耳他 馬爾他
賽事中文名稱	賽事官方名稱	賽事性質	賽事簡介
  马耳他足球超级联赛	Il-Kampjonat, Il-Lig	國內頂級聯賽	於1909年舉行首屆賽事。
  馬爾他盃	Maltese FA Trophy	全國性盃賽	於1933年舉行首屆賽事。
  馬爾他超級盃	Maltese Super Cup	超級盃	於1985年舉行首屆賽事，是由马耳他聯賽冠軍及馬爾他盃冠軍對抗的錦標賽。
摩尔多瓦 摩爾多瓦
賽事中文名稱	賽事官方名稱	賽事性質	賽事簡介
  摩爾多瓦足球聯賽	Divizia Naţională	國內頂級聯賽	於1992年舉行首屆賽事。
  摩尔多瓦足球甲级联赛	Divizia "A"	國內第二級聯賽	於1992年舉行首屆賽事。
  摩尔多瓦足球乙级联赛	Divizia "B"	國內第三級聯賽	於1992年舉行首屆賽事。
  摩尔多瓦杯	Cupa Moldovei	全國性盃賽	於1992年舉行首屆賽事。
  摩尔多瓦超级杯	Supercupa Moldovei	聯賽及盃賽冠軍對抗賽	於2003年舉行首屆賽事。
蒙特內哥羅 黑山
賽事中文名稱	賽事官方名稱	賽事性質	賽事簡介
  黑山足球甲級聯賽	Prva crnogorska fudbalska liga	國內頂級聯賽	於2006年舉行首屆賽事。
  黑山盃	Crnogorski fudbalski kup	全國性盃賽	於2006年舉行首屆賽事。
荷兰 荷蘭
賽事中文名稱	賽事官方名稱	賽事性質	賽事簡介
  荷蘭足球甲級聯賽	Eredivisie	國內頂級聯賽	於1954年舉行首屆賽事。
  荷蘭足球乙級聯賽	Eerste Divisie	國內第二級聯賽	於1956年舉行首屆賽事。
  荷蘭足球丙級聯賽	Topklasse	國內第三級聯賽	於2010年舉行首屆賽事，聯賽分為2個地區組別。
  荷蘭足球丁級聯賽	Hoofdklasse	國內第四級聯賽	於1974年舉行首屆賽事，聯賽分為6個地區組別。
  荷蘭盃	KNVB Cup	全國性盃賽	於1899年舉行首屆賽事。
  告魯夫盾	Johan Cruijff-schaal	超級盃	於1949年舉行首屆賽事，是由荷蘭盃冠軍及荷甲聯賽冠軍對抗的錦標賽。
北爱尔兰 北愛爾蘭
賽事中文名稱	賽事官方名稱	賽事性質	賽事簡介
  北愛爾蘭超級足球聯賽	NIFL Premiership	國內頂級聯賽	於1890年舉行首屆賽事。
  北愛爾蘭冠軍足球聯賽	NIFL Championship	國內第二級聯賽	於1951年舉行首屆賽事，聯賽分為甲組及乙組。
  巴利米納區中級聯賽	Ballymena & Provincial Intermediate League	國內第三級聯賽	於2006年舉行首屆賽事。
  中阿爾斯特區足球聯賽	Mid-Ulster Football League	國內第三級聯賽	於1997年舉行首屆賽事。
  北愛爾蘭北部業餘足球聯賽	Northern Amateur Football League	國內第三級聯賽	於1923年舉行首屆賽事。
  北愛爾蘭中級聯賽	Northern Ireland Intermediate League	國內第三級聯賽	於1978年舉行首屆賽事。
  北愛爾蘭盃	Irish Cup	全國性盃賽	於1881年舉行首屆賽事。
  北愛爾蘭中級盃	Irish Intermediate Cup	低組別盃賽	於1892年舉行首屆賽事，是由超級聯賽預備隊及地區球隊參加的錦標賽。
挪威 挪威
賽事中文名稱	賽事官方名稱	賽事性質	賽事簡介
  挪威足球超级联赛	Tippeligaen	國內頂級聯賽	於1991年舉行首屆賽事。
  挪威足球甲级联赛	Adeccoligaen	國內第二級聯賽	於1963年舉行首屆賽事。
  挪威足球乙级联赛	Fair Play-ligaen	國內第三級聯賽	於1963年舉行首屆賽事，聯賽分為四個組別。
  挪威盃	Norgesmesterskapet i fotball for herrer	全國性盃賽	於1902年舉行首屆賽事。
  挪威超级杯	Superfinalen	超級盃	於2009年舉行首屆賽事。
波兰 波蘭
賽事中文名稱	賽事官方名稱	賽事性質	賽事簡介
  波蘭足球甲级联赛	Ekstraklasa	國內頂級聯賽	於1927年舉行首屆賽事。
  波蘭足球乙级联赛	I liga	國內第二級聯賽	於1949年舉行首屆賽事。
  波蘭足球丙级联赛	II liga	國內第三級聯賽	於2007年舉行首屆賽事。
  波蘭盃	Polish Cup	全國性盃賽	於1925年舉行首屆賽事。
  波蘭超級盃	Polish SuperCup	超級盃	於1983年舉行首屆賽事，是由意甲聯賽冠軍及意大利盃冠軍對抗的錦標賽。
葡萄牙 葡萄牙
賽事中文名稱	賽事官方名稱	賽事性質	賽事簡介
  葡萄牙足球超级联赛	Primeira Liga	國內頂級聯賽	於1934年舉行首屆賽事。
  葡萄牙足球甲級聯賽	Liga de Honra	國內第二級聯賽	於1990年舉行首屆賽事。
  葡萄牙足球乙级联赛	Segunda Divisão Portuguesa	國內第三級聯賽	於1934年舉行首屆賽事，聯賽分為北部、中部及南部三個組別。
  葡萄牙足球丙级联赛	Terceira Divisão Portuguesa	國內第四級聯賽	於1948年舉行首屆賽事，聯賽分為八個地區組別。
  葡萄牙盃	Taça de Portugal	全國性盃賽	於1938年舉行首屆賽事。
  葡萄牙聯賽盃	Taça da Liga	聯賽盃	於2007年舉行首屆賽事。
  葡萄牙超级杯	Supertaça Cândido de Oliveira	超級盃	於1979年舉行首屆賽事，是由葡萄牙盃冠軍及葡超聯賽冠軍對抗的錦標賽。
羅馬尼亞 羅馬尼亞
賽事中文名稱	賽事官方名稱	賽事性質	賽事簡介
  羅馬尼亞足球甲級聯賽	Liga I	國內頂級聯賽	於1909年舉行首屆賽事。
  羅馬尼亞足球乙級聯賽	Liga II	國內第二級聯賽	於1934年舉行首屆賽事。
  羅馬尼亞足球丙級聯賽	Liga III	國內第三級聯賽	於1936年舉行首屆賽事，聯賽分為六個組別。
  羅馬尼亞足球丁級聯賽	Liga IV	國內第三級聯賽	於1936年舉行首屆賽事，聯賽分為四十二個組別。
  羅馬尼亞盃	Cupa României	全國性盃賽	於1933年舉行首屆賽事。
  罗马尼亚超级杯	Supercupa României	超級盃	於1994年舉行首屆賽事，是由羅馬尼亞盃冠軍及聯賽冠軍對抗的錦標賽。
俄罗斯 俄羅斯
賽事中文名稱	賽事官方名稱	賽事性質	賽事簡介
  俄罗斯足球超级联赛	СОГАЗ — Чемпионат России по футболу	國內頂級聯賽	於2001年舉行首屆賽事。
  俄罗斯足球甲级联赛	Первый дивизион	國內頂級聯賽	於1992年舉行首屆賽事。
  俄羅斯盃	Кубок России	全國性盃賽	於1992年舉行首屆賽事。
  俄羅斯超級盃	Суперкубок России	超級盃	於2003年舉行首屆賽事，是由俄超聯賽冠軍及俄羅斯盃冠軍對抗的錦標賽。
圣马力诺 聖馬力諾
賽事中文名稱	賽事官方名稱	賽事性質	賽事簡介
  圣马力诺足球锦标赛	Campionato Sammarinese di Calcio	國內頂級聯賽	於1985年舉行首屆賽事。
  聖馬力諾泰坦盃	Coppa Titano	全國性盃賽	於1937年舉行首屆賽事。
  聖馬力諾聯會盃	Trofeo Federale	超級盃	於1986年舉行首屆賽事。
蘇格蘭 蘇格蘭
賽事中文名稱	賽事官方名稱	賽事性質	賽事簡介
  苏格兰足球超级联赛	Scottish Premier League	國內頂級聯賽	於1998年舉行首屆賽事。
  苏格兰足球甲级联赛	SFL First Division	國內第二級聯賽	於1893年舉行首屆賽事。
  苏格兰足球乙级联赛	SFL Second Division	國內第三級聯賽	於1893年舉行首屆賽事。
  苏格兰足球丙级联赛	SFL Third Division	國內第四級聯賽	於1923年舉行首屆賽事。
  蘇格蘭足總盃	The Scottish Cup	全國性盃賽	於1874年舉行首屆賽事。
  蘇格蘭聯賽盃	Scottish League Cup	全國性盃賽	於1947年舉行首屆賽事。
  蘇格蘭聯賽挑戰盃	Scottish Challenge Cup	低組別盃賽	於1990年舉行首屆賽事，只開始給蘇格蘭足球聯賽的球會參加的錦標賽。
塞尔维亚 塞爾維亞
賽事中文名稱	賽事官方名稱	賽事性質	賽事簡介
  塞尔维亚足球超级联赛	Serbian SuperLiga	國內頂級聯賽	於2006年舉行首屆賽事。
  塞尔维亚足球甲级联赛	Serbian First League	國內第二級聯賽	於2006年舉行首屆賽事。
  塞尔维亚足球乙级联赛	Serbian League	國內第三級聯賽	於2006年舉行首屆賽事。
  塞尔维亚杯	Serbian Cup	全國性盃賽	於2006年舉行首屆賽事。
斯洛伐克 斯洛伐克
賽事中文名稱	賽事官方名稱	賽事性質	賽事簡介
  斯洛伐克足球超級聯賽	Corgoň Liga	國內頂級聯賽	於1993年舉行首屆賽事。
  斯洛伐克足球乙級聯賽	2. Liga	國內第二級聯賽	於1993年舉行首屆賽事。
  斯洛伐克盃	Slovenský Pohár	全國性盃賽	於1993年舉行首屆賽事。
  斯洛伐克超級盃	Slovak Super Cup	超級盃	於1994年舉行首屆賽事，2016年停辦。
  捷克斯洛伐克超級盃	Czechoslovak Supercup	兩國聯辦盃賽	於2017年舉行首屆賽事。
斯洛文尼亚 斯洛文尼亞
賽事中文名稱	賽事官方名稱	賽事性質	賽事簡介
  斯洛文尼亞足球甲級聯賽	Slovenian PrvaLiga	國內頂級聯賽	於1991年舉行首屆賽事。
  斯洛文尼亞足球乙級聯賽	Slovenian 2. SNL	國內第二級聯賽	於1991年舉行首屆賽事。
  斯洛文尼亞足球丙級聯賽	Slovenian 3. SNL	國內第三級聯賽	於1992年舉行首屆賽事，分為東區及西區兩個級別。
  斯洛文尼亞盃	Pokal Slovenije	全國性盃賽	於1991年舉行首屆賽事。
  斯洛文尼亞超級盃	Slovenian Supercup	超級盃	於1995年舉行首屆賽事。
西班牙 西班牙
賽事中文名稱	賽事官方名稱	賽事性質	賽事簡介
  西班牙足球甲级联赛	La Liga	國內頂級聯賽	於1929年舉行首屆賽事。
  西班牙足球乙级联赛	Segunda División	國內第二級聯賽	於1929年舉行首屆賽事。
  西班牙足球乙二级联赛	Segunda División B	國內第三級聯賽	於1977年舉行首屆賽事，聯賽分為4個地區組別。
  西班牙足球丙级联赛	Tercera División	國內第四級聯賽	於1928年舉行首屆賽事，聯賽分為18個地區組別。
  西班牙國王盃	Copa del Rey	全國性盃賽	於1902年舉行首屆賽事。
  西班牙超級盃	Supercopa de España	超級盃	於1982年舉行首屆賽事，是由國王盃冠軍及西甲聯賽冠軍對抗的錦標賽。
瑞典 瑞典
賽事中文名稱	賽事官方名稱	賽事性質	賽事簡介
  瑞典足球超级联赛	Allsvenskan	國內頂級聯賽	於1924年舉行首屆賽事。
  瑞典超級第一足球聯賽	Superettan	國內第二級聯賽	於2000年舉行首屆賽事。
  瑞典甲組足球聯賽	Swedish Football Division 1	國內第三級聯賽	於2006年舉行首屆賽事，分為北區及南區兩個級別。
  瑞典盃	Svenska Cupen	全國性盃賽	於1941年舉行首屆賽事。
  瑞典超級盃	Svenska Supercupen	超級盃	於2007年舉行首屆賽事。
瑞士 瑞士
賽事中文名稱	賽事官方名稱	賽事性質	賽事簡介
  瑞士足球超级联赛	Swiss Super League	國內頂級聯賽	於1897年舉行首屆賽事。
  瑞士足球挑戰聯賽	Swiss Challenge League	國內第二級聯賽	於1897年舉行首屆賽事。
  瑞士晉升甲組足球聯賽	1. Liga Promotion	國內第三級聯賽	於2012年舉行首屆賽事。
  瑞士經典甲組足球聯賽	1. Liga Classic	國內第四級聯賽	於1999年舉行首屆賽事，聯賽分為三個組別。
  瑞士盃	Swiss Cup	全國性盃賽	於1934年舉行首屆賽事。
土耳其 土耳其
賽事中文名稱	賽事官方名稱	賽事性質	賽事簡介
  土耳其足球超级联赛	Süper Lig	國內頂級聯賽	於1959年舉行首屆賽事。
  土耳其甲組足球聯賽	TFF First League	國內第二級聯賽	於2001年舉行首屆賽事。
  土耳其乙組足球聯賽	TFF Second League	國內第三級聯賽	於2001年舉行首屆賽事。
  土耳其丙組足球聯賽	TFF Third League	國內第四級聯賽	於1967年舉行首屆賽事。
  土耳其盃	Turkish Cup	全國性盃賽	於1962年舉行首屆賽事。
  土耳其超級盃	Turkish Super Cup	超級盃	於1966年舉行首屆賽事。
乌克兰 烏克蘭
賽事中文名稱	賽事官方名稱	賽事性質	賽事簡介
  烏克蘭足球超級聯賽	Прем'єр-ліга	國內頂級聯賽	於1991年舉行首屆賽事。
  烏克蘭足球甲級聯賽	перша ліга	國內第二級聯賽	於1992年舉行首屆賽事。
  烏克蘭足球乙級聯賽	друга ліга	國內第三級聯賽	於1992年舉行首屆賽事。
  烏克蘭杯	Кубок України	全國性盃賽	於1992年舉行首屆賽事。
威爾士 威爾斯
賽事中文名稱	賽事官方名稱	賽事性質	賽事簡介
  威尔士足球超级联赛	Welsh Premier League	國內頂級聯賽	於1992年舉行首屆賽事。
  威爾斯甲組足球聯賽	Welsh Football League Division One	國內第二級聯賽	於1904年舉行首屆賽事。
  威爾斯聯盟足球聯賽	Cymru Alliance	國內第二級聯賽	於1990年舉行首屆賽事。
  威爾斯盃	Welsh Cup	全國性盃賽	於1877年舉行首屆賽事。
  威爾斯聯賽盃	Welsh League Cup	聯賽盃	於1992年舉行首屆賽事。
AFC（亞洲區賽事）
阿富汗 | 澳洲 | 巴林 | 孟加拉 | 不丹 | 汶萊 | 柬埔寨 | 中國 | 中華台北 | 關島 | 香港 | 印度 | 印尼 | 伊朗 | 伊拉克  | 日本 | 約旦  | 北韓  | 南韓 | 科威特  | 吉爾吉斯  | 老撾  | 黎巴嫩 | 中國澳門  | 馬來西亞 | 馬爾代夫 | 蒙古  | 緬甸  | 尼泊爾 | 阿曼  | 巴基斯坦  | 巴勒斯坦  |菲律賓 | 卡塔爾 | 沙特阿拉伯 | 新加坡 | 斯里蘭卡 | 敘利亞 | 塔吉克 | 泰國 | 東帝汶 | 土庫曼 | 阿拉伯聯合酋長國 | 烏茲別克 | 越南 | 也門	Asian Football Confederation member associations map.svg
國家隊賽事

AFC官方賽事
賽事中文名稱	賽事官方名稱	賽事簡介
  亞洲盃	AFC Asian Cup	於1956年舉行首屆賽事，每四年舉辦一屆。
  亞洲挑戰盃	AFC Challenge Cup	於2006年舉行首屆賽事，每兩年舉辦一屆。
  亞洲U-22錦標賽	AFC U-22 Championship	於2013年舉行首屆賽事，每兩年舉辦一屆，參賽球員年齡不得超過22歲，每雙數屆會成為奧運會足球比賽亞洲區預賽。
  亞洲U-19錦標賽	AFC U-19 Championship	於1959年舉行首屆賽事，每兩年舉辦一屆，參賽球員年齡不得超過19歲，亦是世青盃亞洲區預賽。
  亞洲U-16錦標賽	AFC U-16 Championship	於1985年舉行首屆賽事，每兩年舉辦一屆，參賽球員年齡不得超過16歲。
  亞洲U-14錦標賽	AFC U-14 Championship	於2014年舉行首屆賽事，參賽球員年齡不得超過14歲。
  亚洲女子足球锦标赛	Asian Women's Championship	於1975年舉行首屆賽事，每四年舉辦一屆。
  亞洲U-19女子錦標賽	AFC U-19 Women's Championship	於2002年舉行首屆賽事，每兩年舉辦一屆。
  亞洲U-16女子錦標賽	AFC U-16 Women's Championship	於2005年舉行首屆賽事，每兩年舉辦一屆。
  亞足聯室内五人足球錦標賽	AFC Futsal Championship	於1999年舉行首屆賽事，原為每年一屆，後於2008年改為每兩年舉辦一屆。
非AFC官方賽事
  亞洲運動會足球比賽	Asian Games football	於1951年舉行首屆賽事，每四年舉辦一屆，由亞洲奧林匹克理事會主辦。
  東亞盃	EAFF East Asian Cup	於2003年舉行首屆賽事，每兩年舉辦一屆，由東亞足球協會主辦。
  南亞足球錦標賽	SAFF Championship	於1993年舉行首屆賽事，每兩年舉辦一屆，由南亞足球協會主辦。
  南亞運動會足球比賽	South Asian Games	於1984年舉行首屆賽事，每四年舉辦一屆，由南亞體育理事會主辦。
  東南亞足球錦標賽	ASEAN Football Championship	於1996年舉行首屆賽事，每兩年舉辦一屆，由亞細安足球協會主辦。
  東南亞運動會足球比賽	Southeast Asian Games	於1959年舉行首屆賽事，每四年舉辦一屆，由東南亞運動會聯盟主辦。
  西亞足球錦標賽	West Asian Football Federation Championship	於2000年舉行首屆賽事，每兩年舉辦一屆，由西亞足球協會主辦。
  女子東亞盃	Women's East Asian Cup	於2005年舉行首屆賽事，每兩年舉辦一屆。
球會賽事

AFC官方賽事
賽事中文名稱	賽事官方名稱	賽事簡介
  亞洲聯賽冠軍盃	AFC Champions League	於1967年舉行首屆賽事，每年舉辦一屆。
  亞洲足協盃	AFC Cup	於2004年舉行首屆賽事，每年舉辦一屆。
  亞洲足協會長盃	AFC President's Cup	於2005年舉行首屆賽事，每年舉辦一屆。
  亞足聯五人制足球會錦標賽	AFC Futsal Club Championship	於2010舉行首屆賽事，每年舉辦一屆。
非AFC官方賽事
  A3冠軍杯	A3 Champions Cup	曾經於2003年至2008年舉辦，每年舉辦一屆，是一項由 中国、 日本及 韩国三國球會參加的錦標賽，並由三國輪流主辦。
  亞洲盃賽冠軍盃	Asian Cup Winners' Cup	曾經於1991年至2002年舉辦，每年舉辦一屆，於2003年與亞洲冠軍盃合併成為亞洲聯賽冠軍盃。
  亞洲超級盃	Asian Super Cup	曾經於1995年至2002年舉辦，每年舉辦一屆，是一項由亞洲盃賽冠軍盃及亞洲冠軍盃對抗的錦標賽。
阿富汗 阿富汗
賽事中文名稱	賽事官方名稱	賽事性質	賽事簡介
  阿富汗超級足球聯賽	Afghan Premier League	國內頂級聯賽	於2012年舉行首屆賽事。
澳大利亚 澳洲
賽事中文名稱	賽事官方名稱	賽事性質	賽事簡介
  澳洲職業足球聯賽	A-League	國內頂級聯賽	於2004年舉行首屆賽事。
  澳洲首都特區超級足球聯賽	ACT Premier League	國內第二級聯賽	於2000年舉行首屆賽事。
  新南威爾士州北部地區足球聯賽	Northern NSW State Football League	國內第二級聯賽	於2001年舉行首屆賽事。
  新南威爾士州超級足球聯賽	NSW Premier League	國內第二級聯賽	於2001年舉行首屆賽事。
  北領地超級足球聯賽	NT Premier League	國內第二級聯賽	於2005年舉行首屆賽事。
  昆士蘭州地區足球聯賽	QLD Premier League	國內第二級聯賽	於2012年舉行首屆賽事。
  南澳洲超級足球聯賽	FFSA Premier League	國內第二級聯賽	於2005年舉行首屆賽事。
  塔斯馬尼亞州足球聯賽	T-League	國內第二級聯賽	於2012年舉行首屆賽事。
  維多利亞州超級足球聯賽	VIC Premier League	國內第二級聯賽	於1909年舉行首屆賽事。
  南澳洲超級足球聯賽	WA Premier League	國內第二級聯賽	於1896年舉行首屆賽事。
  澳洲青年足球聯賽	A-League National Youth League	青年聯賽	於2008年舉行首屆賽事，參賽球員年齡不得超過21歲。
  澳洲足總盃	FFA Cup	全國性盃賽	於2014年舉行首屆賽事。
  澳洲職業女子足球聯賽	W-League	女子國內頂級聯賽	於2008年舉行首屆賽事。
巴林 巴林
賽事中文名稱	賽事官方名稱	賽事性質	賽事簡介
  巴林超級足球聯賽	Bahraini Premier League	國內頂級聯賽	於1957年舉行首屆賽事。
  巴林國王盃	Bahraini King's Cup	全國性盃賽	於1952年舉行首屆賽事。
  巴林足總盃	Bahraini FA Cup	全國性盃賽	於2000年舉行首屆賽事。
孟加拉国 孟加拉
賽事中文名稱	賽事官方名稱	賽事性質	賽事簡介
  孟加拉超級足球聯賽	Bangladesh Premier League	國內頂級聯賽	於2007年舉行首屆賽事。
  孟加拉冠軍足球聯賽	Bangladesh Championship League	國內頂級聯賽	於2012年舉行首屆賽事。
  孟加拉足總盃	Bangladesh Federation Cup	全國性盃賽	於1980年舉行首屆賽事。
  孟加拉超級盃	Bangladesh Super Cup	聯賽及盃賽冠軍對抗賽	於2009年舉行首屆賽事。
不丹 不丹
賽事中文名稱	賽事官方名稱	賽事性質	賽事簡介
  不丹足球甲级联赛	A-Division	國內頂級聯賽	於1986年舉行首屆賽事。
汶莱 汶萊
賽事中文名稱	賽事官方名稱	賽事性質	賽事簡介
  汶萊超級足球聯賽	Brunei Super League	國內頂級聯賽	於2012年舉行首屆賽事。
柬埔寨 柬埔寨
賽事中文名稱	賽事官方名稱	賽事性質	賽事簡介
  柬埔寨足球联赛	Cambodian League	國內頂級聯賽	於1982年舉行首屆賽事。
  洪森盃	Hun Sen Cup	全國性盃賽	於2007年舉行首屆賽事。
中国 中華人民共和國
賽事中文名稱	賽事官方名稱	賽事性質	賽事簡介
  中国足球超级联赛	Chinese Super League	國內頂級聯賽	於2004年舉行首屆賽事。
  中国足球甲级联赛	Chinese Football Association Jia League	國內第二級聯賽	於2004年舉行首屆賽事。
  中国足球乙级联赛	Chinese Football Association Yi League	國內第三級聯賽	於2004年舉行首屆賽事。
  全國足球業餘聯賽	China Amateur Football League	國內第四級聯賽	於2002年舉行首屆賽事。
  中国足協杯	Chinese FA Cup	全國性盃賽	於1995年舉行首屆賽事。
  中国足協超級盃	Chinese FA Super Cup	超級盃	於1995年舉行首屆賽事，是由足協盃冠軍及中超聯賽冠軍對抗的錦標賽。
中華臺北 中華民國
賽事中文名稱	賽事官方名稱	賽事性質	賽事簡介
  臺灣企業甲級足球聯賽	Taiwan Football Premier League	國內頂級聯賽	於2017年舉行首屆賽事。
關島 關島
賽事中文名稱	賽事官方名稱	賽事性質	賽事簡介
  關島男子足球聯賽	Guam Men's Soccer League	國內頂級聯賽	於1990年舉行首屆賽事。
  關島足總盃	Guam FA Cup	全國性盃賽	於2008年舉行首屆賽事。
香港 中國香港
賽事中文名稱	賽事官方名稱	賽事性質	賽事簡介
  香港超級聯賽	Hong Kong Premier League	國內頂級聯賽	於2014年舉行首屆賽事。
  香港甲組足球聯賽	Hong Kong First Division League	國內第二級聯賽	於1908年舉行首屆賽事。
  香港乙組足球聯賽	Hong Kong Second Division League	國內第三級聯賽	於1946年舉行首屆賽事。
  香港丙組足球聯賽	Hong Kong Third Division League	國內第四級聯賽	於1951年舉行首屆賽事。
  香港丁組足球聯賽	Hong Kong Fourth Division League	國內第五級聯賽	於1955年舉行首屆賽事。
  香港預備組聯賽	Hong Kong Reserve Division League	預備組聯賽	於1956年舉行首屆賽事。
  香港高級組銀牌	Hong Kong Senior Challenge Shield	全國性盃賽	於1896年舉行首屆賽事。
  香港足總盃	Hong Kong FA Cup	全國性盃賽	於1974年舉行首屆賽事。
  香港初級組銀牌	Hong Kong Junior Challenge Shield	低級別盃賽	於1922年舉行首屆賽事。
  賀歲盃足球賽	Lunar New Year Cup	國際性友誼賽	於1948年舉行首屆賽事。
  港澳埠際足球賽	Hong Kong Macau Interport	國際性友誼賽	於1937年舉行首屆賽事，是由香港足球代表隊與澳門足球代表隊每年一度角逐的埠際足球錦標賽。
  省港盃	Hong Kong Guangdong Cup	國際性友誼賽	於1979年舉行首屆賽事，是由廣東省與香港之間的一項足球錦標賽。
  滬港球會盃	Hong Kong–Shanghai Inter Club Championship	國際性友誼賽	於1908年舉行首屆賽事，是由上海與香港之間的一項足球錦標賽。
  香港女子足球聯賽	Hong Kong Women League	女子國內頂級聯賽	於2012年舉行首屆賽事。
  香港女子聯賽足總盃	Hong Kong Women League FA Cup	女子全國性盃賽	於2012年舉行首屆賽事。
  香港聯賽盃	Hong Kong League Cup	全國性盃賽	曾經於2000年至2012年舉辦。
  香港慈善盾	Hong Kong Community Shield	全國性盃賽	曾經於2009年舉辦一屆。
  香港總督盃	Viceroy Cup	全國性盃賽	曾經於1969年至1998年舉辦。
  胡好盃	Aw Hoe Cup	全國性盃賽	曾經於1988年至1997年舉辦。
  士丹利木盾	Stanley Shield	全國性盃賽	曾經於1945年至1979年舉辦。
印度 印度
賽事中文名稱	賽事官方名稱	賽事性質	賽事簡介
  印度足球甲级联赛	I-League	國內頂級聯賽	於2007年舉行首屆賽事。
  印度足球乙级联赛	I-League 2nd Division	國內第二級聯賽	於2008年舉行首屆賽事。
印度尼西亚 印尼
賽事中文名稱	賽事官方名稱	賽事性質	賽事簡介
IPL聯賽體系
  印尼首要足球聯賽	Indonesian Premier League	國內頂級聯賽	於2011年舉行首屆賽事。
  印尼首要級別足球聯賽	Indonesian Premier Division	國內第二級聯賽	於1994年舉行首屆賽事。
ISL聯賽體系
  印尼足球超级联赛	Indonesia Super League	非官方認可國內頂級聯賽	於2008年舉行首屆賽事。
  印尼高級足球聯賽	Liga Indonesia Premier Division	非官方認可國內第二級聯賽	於1994年舉行首屆賽事。
伊朗 伊朗
賽事中文名稱	賽事官方名稱	賽事性質	賽事簡介
  伊朗職業足球聯賽	Iran Pro League	國內頂級聯賽	於1970年舉行首屆賽事。
  伊朗足球甲級聯賽	Azadegan League	國內第二級聯賽	於1991年舉行首屆賽事。
伊拉克 伊拉克
賽事中文名稱	賽事官方名稱	賽事性質	賽事簡介
  伊拉克超級足球聯賽	Iraqi Premier League	國內頂級聯賽	於1974年舉行首屆賽事。
  伊拉克甲組足球聯賽	Iraq Division 1	國內第二級聯賽	於2012年舉行首屆賽事。
  伊拉克足協盃	Iraq FA Cup	全國性盃賽	於1958年舉行首屆賽事。
日本 日本
主条目：日本足球聯賽系統
賽事中文名稱	賽事官方名稱	賽事性質	賽事簡介
  麒麟盃	キリンカップサッカー	國家隊賽事	於1978年舉行首屆賽事。
  日本職業甲組足球聯賽	Jリーグ ディビジョン1	國內頂級聯賽	於1992年舉行首屆賽事。
  日本職業乙組足球聯賽	Jリーグ ディビジョン2	國內第二級聯賽	於1992年舉行首屆賽事。
  日本職業丙組足球聯賽	J3リーグ	國內第三級聯賽	於2013年舉行首屆賽事。
  日本足球聯賽	日本フットボールリーグ	國內第三級聯賽	於1999年舉行首屆賽事。
  北海道足球聯賽	北海道サッカーリーグ	國內第四級聯賽	於1978年舉行首屆賽事，日本地區足球聯賽其中之一。
  東北足球聯賽	東北社会人サッカーリーグ	國內第四級聯賽	於1977年舉行首屆賽事，日本地區足球聯賽其中之一。
  關東足球聯賽	関東サッカーリーグ	國內第四級聯賽	於1967年舉行首屆賽事，日本地區足球聯賽其中之一。
  北信越足球聯賽	北信越フットボールリーグ	國內第四級聯賽	於1975年舉行首屆賽事，日本地區足球聯賽其中之一。
  東海足球聯賽	東海社会人リーグ	國內第四級聯賽	於1966年舉行首屆賽事，日本地區足球聯賽其中之一。
  關西足球聯賽	関西サッカーリーグ	國內第四級聯賽	於1966年舉行首屆賽事，日本地區足球聯賽其中之一。
  中國足球聯賽	中国サッカーリーグ	國內第四級聯賽	於1977年舉行首屆賽事，日本地區足球聯賽其中之一。
  四國足球聯賽	四国社会人リーグ	國內第四級聯賽	於1973年舉行首屆賽事，日本地區足球聯賽其中之一。
  九州足球聯賽	九州サッカーリーグ	國內第四級聯賽	於1977年舉行首屆賽事，日本地區足球聯賽其中之一。
  天皇盃	天皇杯全日本サッカー選手権大会	全國性盃賽	於1921年舉行首屆賽事。
  日本联賽盃	Jリーグカップ	联賽盃	於1992年舉行首屆賽事。
  日本超級盃	FUJI XEROX SUPER CUP	超級盃	於1994年舉行首屆賽事。是由天皇盃冠軍及日本職業甲組足球聯賽冠軍對抗的錦標賽。
约旦 約旦
賽事中文名稱	賽事官方名稱	賽事性質	賽事簡介
  約旦超級足球聯賽	دوري المناصير الأردني للمحترفين	國內頂級聯賽	於1944年舉行首屆賽事。
朝鲜民主主义人民共和国 北韓
賽事中文名稱	賽事官方名稱	賽事性質	賽事簡介
  北韓足球聯賽	공화국선수권축구대회	國內頂級聯賽	
大韩民国 南韓
賽事中文名稱	賽事官方名稱	賽事性質	賽事簡介
  經典K聯賽	K League Classic（K리그 클래식）	國內頂級聯賽	於1983年舉行首屆賽事。
  挑戰K聯賽	K League Challenge（K리그 챌린지）	國內第二級聯賽	於2013年舉行首屆賽事。
  南韓國家足球聯賽	Korea National League（내셔널리그）	國內第三級聯賽	於2003年舉行首屆賽事。
  南韓挑戰足球聯賽	K3 Challengers League（K3리그）	國內第四級聯賽	於2007年舉行首屆賽事。
  韓國足總盃	Korean FA Cup（FA컵）	全國性盃賽	於1996年舉行首屆賽事。
  南韓國家足球聯賽錦標賽	Korea National League Championship（내셔널축구선수권대회）	全國性盃賽	於2004年舉行首屆賽事。
科威特 科威特
賽事中文名稱	賽事官方名稱	賽事性質	賽事簡介
  科威特超級足球聯賽	Kuwaiti Premier League	國內頂級聯賽	於1961年舉行首屆賽事。
吉尔吉斯斯坦 吉爾吉斯
賽事中文名稱	賽事官方名稱	賽事性質	賽事簡介
  吉爾吉斯甲組足球聯賽	Kyrgyzstan League	國內頂級聯賽	於1992年舉行首屆賽事。
老挝 老撾
賽事中文名稱	賽事官方名稱	賽事性質	賽事簡介
  老撾超級足球聯賽	Lao Premier League	國內頂級聯賽	於1990年舉行首屆賽事。
黎巴嫩 黎巴嫩
賽事中文名稱	賽事官方名稱	賽事性質	賽事簡介
  黎巴嫩超級足球聯賽	لدوري اللبناني لكرة القدم)	國內頂級聯賽	於1934年舉行首屆賽事。
澳門 中國澳門
賽事中文名稱	賽事官方名稱	賽事性質	賽事簡介
  澳門甲組足球聯賽	Campeonato da 1ª Divisão do Futebol	國內頂級聯賽	於1973年舉行首屆賽事。
  澳門乙組足球聯賽	Campeonato da 2ª Divisão do Futebol	國內第二級聯賽	於2005年舉行首屆賽事。
  澳門丙組足球聯賽	Campeonato da 3ª Divisão do Futebol	國內第三級聯賽	於2005年舉行首屆賽事。
  澳門足總盃	Taça de Macau em Futebol	全國性盃賽	於2005年舉行首屆賽事。
马来西亚 馬來西亞
賽事中文名稱	賽事官方名稱	賽事性質	賽事簡介
  馬來西亞超級足球聯賽	Liga Super Malaysia	國內頂級聯賽	於2004年舉行首屆賽事。
  馬來西亞首要足球聯賽	Malaysia Premier League	國內第二級聯賽	於2004年舉行首屆賽事。
  馬來西亞金盃	Malaysia Cup	全國性盃賽	於1921年舉行首屆賽事。
  馬來西亞足協盃	FA Cup Malaysia	全國性盃賽	於1990年舉行首屆賽事。
  馬來西亞慈善盾	Sultan Haji Ahmad Shah Cup	全國性盃賽	於1985年舉行首屆賽事。
马尔代夫 馬爾代夫
賽事中文名稱	賽事官方名稱	賽事性質	賽事簡介
  马尔代夫足球联赛	Dhivehi League	國內頂級聯賽	於1983年舉行首屆賽事。
蒙古 蒙古
賽事中文名稱	賽事官方名稱	賽事性質	賽事簡介
  蒙古足球甲级联赛	Нийслэл Лиг	國內頂級聯賽	於1974年舉行首屆賽事。
缅甸 緬甸
賽事中文名稱	賽事官方名稱	賽事性質	賽事簡介
  缅甸全国足球联赛	Myanmar_National_League	國內頂級聯賽	於2009年舉行首屆賽事。
  緬甸足協盃	MFF Cup	全國性盃賽	於2010年舉行首屆賽事。
尼泊爾 尼泊爾
賽事中文名稱	賽事官方名稱	賽事性質	賽事簡介
  尼泊爾足球甲級联赛	Martyr's Memorial A-Division League	國內頂級聯賽	於1954年舉行首屆賽事。
阿曼 阿曼
賽事中文名稱	賽事官方名稱	賽事性質	賽事簡介
  阿曼足球联赛	الدوري العماني	國內頂級聯賽	於1976年舉行首屆賽事。
巴基斯坦 巴基斯坦
賽事中文名稱	賽事官方名稱	賽事性質	賽事簡介
  巴基斯坦足球甲级联赛	Pakistan Premier League	國內頂級聯賽	於2004年舉行首屆賽事。
巴勒斯坦 巴勒斯坦
菲律宾 菲律賓
賽事中文名稱	賽事官方名稱	賽事性質	賽事簡介
  菲律賓聯合足球聯賽	United Football League	國內頂級聯賽	於2009年舉行首屆賽事。
  菲律宾足球锦标赛	PFF National Men's Open Championship	全國性盃賽	於2011年舉行首屆賽事。
卡塔尔 卡塔爾
賽事中文名稱	賽事官方名稱	賽事性質	賽事簡介
  卡塔尔足球星级联赛	دوري نجوم قطر	國內頂級聯賽	於1963年舉行首屆賽事。
沙特阿拉伯 沙特阿拉伯
賽事中文名稱	賽事官方名稱	賽事性質	賽事簡介
  沙特职业足球联赛	دوري المحترفين السعودي	國內頂級聯賽	於1976年舉行首屆賽事。
新加坡 新加坡
賽事中文名稱	賽事官方名稱	賽事性質	賽事簡介
  新加坡职业足球联赛	S.League	國內頂級聯賽	於1996年舉行首屆賽事。
  新加坡盃	Singapore Cup	全國性盃賽	於1998年舉行首屆賽事。
  新加坡聯賽盃	Singapore League Cup	聯賽盃	於2007年舉行首屆賽事。
  新加坡慈善盾	Singapore Charity Shield	全國性盃賽	於2008年舉行首屆賽事。
斯里蘭卡 斯里蘭卡
賽事中文名稱	賽事官方名稱	賽事性質	賽事簡介
  斯里兰卡足球超级联赛	Sri Lanka Football Premier League	國內頂級聯賽	於1985年舉行首屆賽事。
叙利亚 敘利亞
賽事中文名稱	賽事官方名稱	賽事性質	賽事簡介
  叙利亚足球超级联赛	الدوري السوري	國內頂級聯賽	於1966年舉行首屆賽事。
塔吉克斯坦 塔吉克
泰国 泰國
賽事中文名稱	賽事官方名稱	賽事性質	賽事簡介
  泰國超級足球聯賽	Thai Premier League	國內頂級聯賽	於1996年舉行首屆賽事。
  泰國足總盃	Thai FA Cup	國內盃賽	於1980年舉行首屆賽事。
东帝汶 東帝汶
賽事中文名稱	賽事官方名稱	賽事性質	賽事簡介
  東帝汶足球超級聯賽	Super Liga Timorense	國內頂級聯賽	於2004年舉行首屆賽事。
土库曼斯坦 土庫曼
阿拉伯联合酋长国 阿拉伯聯合酋長國
賽事中文名稱	賽事官方名稱	賽事性質	賽事簡介
  阿聯酋阿拉伯海灣聯賽	UAE Arabian Gulf League	國內頂級聯賽	於1973年舉行首屆賽事。
乌兹别克斯坦 烏茲別克
賽事中文名稱	賽事官方名稱	賽事性質	賽事簡介
  烏茲別克職業足球聯賽	Uzbek League	國內頂級聯賽	於1992年舉行首屆賽事。
越南 越南
賽事中文名稱	賽事官方名稱	賽事性質	賽事簡介
  越南足球冠军联赛	V.League 1	國內頂級聯賽	於1980年舉行首屆賽事。
  越南足球甲級联赛	V.League 2	國內第二級聯賽	於2001年舉行首屆賽事。
  越南足球乙級联赛	Giải bóng đá hạng nhì quốc gia Việt Nam	國內第三級聯賽	於1999年舉行首屆賽事。
  越南足球丙級联赛	Giải bóng đá hạng ba quốc gia Việt Nam	國內第四級聯賽	於2001年舉行首屆賽事。
  越南盃	Cúp quốc gia Việt Nam	全國性盃賽	於1992年舉行首屆賽事。
也门 也門
賽事中文名稱	賽事官方名稱	賽事性質	賽事簡介
  也門足球聯賽	Yemeni League	國內頂級聯賽	於1990年舉行首屆賽事。
CONMEBOL （南美洲區賽事）
阿根廷 | 玻利維亞 | 巴西 | 智利 | 哥倫比亞 | 厄瓜多爾 | 巴拉圭 | 秘魯 | 烏拉圭 | 委內瑞拉	CONMEBOL member associations map.svg
國家隊賽事

CONMEBOL官方賽事
賽事中文名稱	賽事官方名稱	賽事簡介
  美洲國家盃	Copa América	於1916年舉行首屆賽事，每四年舉辦一屆。
  南美超級打吡盃	Superclásico de las Américas	於2011年舉行首屆賽事，每年舉辦一次，是一項由阿根廷對巴西對抗的錦標賽。
  南美青年足球錦標賽	South American Youth Championship	於1945年舉行首屆賽事，每兩年舉辦一屆，參賽球員年齡不得超過19歲。
  南美17歲以下足球錦標賽	South American Under-17 Football Championship	於1985年舉行首屆賽事，每兩年舉辦一屆，參賽球員年齡不得超過17歲。
  南美15歲以下足球錦標賽	South American Under-15 Football Championship	於2004年舉行首屆賽事，每兩年舉辦一屆，參賽球員年齡不得超過15歲。
  南美洲女子足球錦標賽	Copa América Femenina	於1991年舉行首屆賽事，每四年舉辦一屆。
  南美U20女子錦標賽	South American Under-20 Women's Football Championship	於2004年舉行首屆賽事，每兩年舉辦一屆，參賽球員年齡不得超過20歲。
  南美U17女子錦標賽	South American Under-17 Women's Football Championship	於2008年舉行首屆賽事，每兩年舉辦一屆，參賽球員年齡不得超過17歲。
  南美洲室内五人足球锦标赛	Copa América de Futsal	於1964年舉行首屆賽事。
  南美洲青年室内五人足球锦标赛	South American Under-20 Futsal Championship	於2004年舉行首屆賽事，每兩年舉辦一屆。
  南美洲女子室内五人足球锦标赛	South American Women's Futsal Championship	於2005年舉行首屆賽事，每兩年舉辦一屆。
  南美洲沙灘足球錦標賽	CONMEBOL Beach Soccer Championship	於2005年舉行首屆賽事，每兩年舉辦一屆。
  南美洲區奧運男子足球錦標賽	CONMEBOL Men Pre-Olympic Tournament	曾經於1960年至2004年舉辦，每四年舉辦一屆，賽事是夏季青年奧林匹克運動會足球比賽的南美洲區預選賽，賽事停辦後改由南美青年足球錦標賽作為預選賽。
球會賽事

CONMEBOL官方賽事
賽事中文名稱	賽事官方名稱	賽事簡介
  南美自由盃	Copa Libertadores	於1960年舉行首屆賽事，每年舉辦一屆。
  南美球會盃	Copa Sudamericana	於2002年舉行首屆賽事，每年舉辦一屆。
  南美优胜者杯	Recopa Sudamericana	於1989年舉行首屆賽事，每年舉辦一屆。
  南美足協盃	Copa CONMEBOL	曾經於1992年至1999年舉辦，每年舉辦一屆。
  南美超級球會盃	Supercopa Libertadores	曾經於1988年至1997年舉辦，每年舉辦一屆，參賽球隊來自阿根廷、巴西、智利、哥倫比亞、巴拉圭及烏拉圭。
  北方共同市場盃	Copa Merconorte	曾經於1998年至2001年舉辦，每年舉辦一屆，參賽球隊來自委內瑞拉、哥倫比亞、厄瓜多爾、秘魯、玻利維亞、美國、哥斯達黎加及墨西哥。
  南方共同市場盃	Copa Mercosur	曾經於1998年至2001年舉辦，每年舉辦一屆，參賽球隊來自巴西、阿根廷、烏拉圭、巴拉圭及智利。
  南美洲俱樂部錦標賽	South American Championship of Champions	只曾經於1948年舉辦一屆，繼後南美足協考慮過該項賽事的概念，亦成為南美解放者盃的前身。
  南美金盃賽	Copa de Oro Nicolás Leoz	曾經於1993年至1996年舉辦三屆，是一項給予南美自由盃冠軍、南美超級球會盃冠軍南美足協盃冠軍、南美大師超級盃冠軍及CONMEBOL大師盃冠軍參與的錦標賽。
  南美大師超級盃	Copa Master de Supercopa	曾經於1992年至1995年舉辦兩屆，是一項給予多支前南美超級球會盃冠軍隊伍參與的錦標賽。
  CONMEBOL大師盃	Copa Master de la Copa CONMEBOL	曾經於1996年舉辦一屆，是一項給予1992年至1995年南美足協盃冠軍隊伍參與的錦標賽。
與CONCACAF共同合辦賽事
賽事中文名稱	賽事官方名稱	賽事簡介
  南美國際盃	Copa Interamericana	曾經於1968年至1998年舉辦，是一項南美自由盃冠軍及CONCACAF聯賽冠軍盃冠軍對抗的錦標賽。
阿根廷 阿根廷
賽事中文名稱	賽事官方名稱	賽事性質	賽事簡介
  阿根廷足球甲級聯賽	Primera División	國內頂級聯賽	於1891年舉行首屆賽事。
  阿根廷足球乙級聯賽全國組	Primera B Nacional	國內第二級聯賽	於1986年舉行首屆賽事。
  阿根廷超級聯賽盃	Copa de la Superliga	全國性盃賽	於2019年舉行首屆賽事，參賽隊伍只限於阿根廷足球甲級聯賽角逐的球隊。
  阿根廷超級盃	Supercopa Argentina	超級盃	於2012年舉行首屆賽事，參賽隊伍由阿根廷足球甲級聯賽冠軍對陣阿根廷盃冠軍。
  阿根廷杯	Copa Argentina	全國性盃賽	於1969年舉行首屆賽事，2011年重辦。
大布宜諾斯艾利斯
  阿根廷乙組足球聯賽大都會組	Primera B Metropolitana	國內第三級聯賽	於1899年舉行首屆賽事。
  阿根廷丙組足球聯賽大都會組	Primera C Metropolitana	國內第四級聯賽	於1900年舉行首屆賽事。
  阿根廷丁組足球聯賽大都會組	Primera D Metropolitana	國內第五級聯賽	於1900年舉行首屆賽事。
大布宜諾斯艾利斯以外地區
  阿根廷A級錦標賽	Torneo Argentino A	國內第三級聯賽	於1995年舉行首屆賽事。
  阿根廷B級錦標賽	Torneo Argentino B	國內第四級聯賽	於1995年舉行首屆賽事。
  阿根廷C級錦標賽	Torneo Argentino C	國內第五級聯賽	於2005年舉行首屆賽事。
玻利維亞 玻利維亞
賽事中文名稱	賽事官方名稱	賽事性質	賽事簡介
  玻利维亚足球甲級聯賽	Liga de Fútbol Profesional Boliviano	國內頂級聯賽	於1977年舉行首屆賽事。
  玻利维亚足球乙級聯賽	Liga Nacional B	國內第二級聯賽	於2011年舉行首屆賽事。
巴西 巴西
賽事中文名稱	賽事官方名稱	賽事性質	賽事簡介
  巴西足球甲級聯賽	Campeonato Brasileiro Série A	國內頂級聯賽	於1971年舉行首屆賽事。
  巴西足球乙級聯賽	Campeonato Brasileiro Série B	國內第二級聯賽	於1971年舉行首屆賽事。
  巴西足球丙級聯賽	Campeonato Brasileiro Série C	國內第三級聯賽	於1981年舉行首屆賽事。
  巴西足球丁級聯賽	Campeonato Brasileiro Série D	國內第四級聯賽	於2009年舉行首屆賽事。
  巴西杯	Copa do Brasil	全國性盃賽	於1989年舉行首屆賽事。
省級聯賽
  阿克里州足球聯賽	Campeonato Acriano	省級第一級聯賽	於1947年舉行首屆賽事。
  阿拉戈斯州足球聯賽	Campeonato Alagoano	省級第一級聯賽	於1927年舉行首屆賽事。
  阿馬帕州足球聯賽	Campeonato Amapaense	省級第一級聯賽	於1944年舉行首屆賽事。
  亞馬遜州足球聯賽	Campeonato Amazonense	省級第一級聯賽	於1914年舉行首屆賽事。
  巴伊亞州足球聯賽	Campeonato Baiano	省級第一級聯賽	於1905年舉行首屆賽事。
  塞阿拉州足球聯賽	Campeonato Cearense	省級第一級聯賽	於1915年舉行首屆賽事。
  巴西利亞足球聯賽	Campeonato Brasiliense	省級第一級聯賽	於1959年舉行首屆賽事。
  聖埃斯皮里圖州足球聯賽	Campeonato Capixaba	省級第一級聯賽	於1917年舉行首屆賽事。
  戈亞斯州足球聯賽	Campeonato Goiano	省級第一級聯賽	於1944年舉行首屆賽事。
  馬拉尼昂州足球聯賽	Campeonato Maranhense	省級第一級聯賽	於1918年舉行首屆賽事。
  托格羅索州足球聯賽	Campeonato Mato-Grossense	省級第一級聯賽	於1943年舉行首屆賽事。
  南馬托格羅索州足球聯賽	Campeonato Sul-Mato-Grossense	省級第一級聯賽	於1979年舉行首屆賽事。
  米納斯吉拉斯州足球聯賽	Campeonato Mineiro	省級第一級聯賽	於1915年舉行首屆賽事。
  帕拉州足球聯賽	Campeonato Paraense	省級第一級聯賽	於1908年舉行首屆賽事。
  帕拉伊巴州足球聯賽	Campeonato Paraibano	省級第一級聯賽	於1919年舉行首屆賽事。
  巴拉那州足球聯賽	Campeonato Paranaense	省級第一級聯賽	於1915年舉行首屆賽事。
  伯南布哥州足球聯賽	Campeonato Pernambucano	省級第一級聯賽	於1915年舉行首屆賽事。
  皮奧伊州足球聯賽	Campeonato Piauiense	省級第一級聯賽	於1941年舉行首屆賽事。
  里約熱內盧州足球聯賽	Campeonato Carioca	省級第一級聯賽	於1906年舉行首屆賽事。
  北大河州足球聯賽	Campeonato Potiguar	省級第一級聯賽	於1919年舉行首屆賽事。
  南大河州足球聯賽	Campeonato Gaúcho	省級第一級聯賽	於1919年舉行首屆賽事。
  朗多尼亞州足球聯賽	Campeonato Rondoniense	省級第一級聯賽	於1945年舉行首屆賽事。
  羅賴馬州足球聯賽	Campeonato Roraimense	省級第一級聯賽	於1974年舉行首屆賽事。
  聖卡塔琳娜州足球聯賽	Campeonato Catarinense	省級第一級聯賽	於1924年舉行首屆賽事。
  聖保羅州足球聯賽	Campeonato Paulista	省級第一級聯賽	於1902年舉行首屆賽事。
  塞爾希培州足球聯賽	Campeonato Sergipano	省級第一級聯賽	於1918年舉行首屆賽事。
  托坎廷斯州足球聯賽	Campeonato Tocantinense	省級第一級聯賽	於1993年舉行首屆賽事。
  米纳斯吉拉斯州杯	Copa do Brasil	省級性盃賽	於1973年舉行首屆賽事。
  里約熱內盧州杯	Copa Rio	省級性盃賽	於1991年舉行首屆賽事。
  南大河州杯	Copa Federação Gaúcha de Futebol	省級性盃賽	於2004年舉行首屆賽事。
  聖卡塔琳娜州杯	Copa Santa Catarina	省級性盃賽	於1990年舉行首屆賽事。
  聖保羅州杯	Copa Paulista	省級性盃賽	於1999年舉行首屆賽事。
智利 智利
賽事中文名稱	賽事官方名稱	賽事性質	賽事簡介
  智利超級足球聯賽	Liga Chilena de Fútbol: Primera División	國內頂級聯賽	於1933年舉行首屆賽事。
  智利足球甲级联赛	Primera B de Chile	國內第二級聯賽	於1952年舉行首屆賽事。
  智利杯	Copa Chile	全國性盃賽	於1958年舉行首屆賽事。
  智利超級盃	Copa Chile	聯賽與盃賽冠軍對抗賽	於2013年舉行首屆賽事。
哥伦比亚 哥倫比亞
賽事中文名稱	賽事官方名稱	賽事性質	賽事簡介
  哥伦比亚足球甲级联赛	Categoría Primera A	國內頂級聯賽	於1948年舉行首屆賽事。
厄瓜多尔 厄瓜多爾
賽事中文名稱	賽事官方名稱	賽事性質	賽事簡介
  厄瓜多尔足球甲级联赛	Ecuadorian Serie A	國內頂級聯賽	於1957年舉行首屆賽事。
  厄瓜多尔足球乙级联赛	Ecuadorian Serie B	國內第二級聯賽	於1971年舉行首屆賽事。
巴拉圭 巴拉圭
賽事中文名稱	賽事官方名稱	賽事性質	賽事簡介
  巴拉圭足球甲级联赛	Paraguayan Primera División	國內頂級聯賽	於1906年舉行首屆賽事。
秘鲁 秘魯
賽事中文名稱	賽事官方名稱	賽事性質	賽事簡介
  秘魯足球甲级联赛	Peruvian Primera División	國內頂級聯賽	於1912年舉行首屆賽事。
  秘魯足球乙级联赛	Peruvian Segunda División	國內第二級聯賽	於1936年舉行首屆賽事。
乌拉圭 烏拉圭
賽事中文名稱	賽事官方名稱	賽事性質	賽事簡介
  烏拉圭足球甲级联赛	Uruguayan Primera División	國內頂級聯賽	於1900年舉行首屆賽事。
委內瑞拉 委內瑞拉
賽事中文名稱	賽事官方名稱	賽事性質	賽事簡介
  委内瑞拉足球甲级联赛	Venezuelan Primera División	國內頂級聯賽	於1921年舉行首屆賽事。
CONCACAF （北美洲、中美洲及加勒比海地區賽事）
安圭拉 | 加拿大 | 哥斯達黎加 | 墨西哥 | 美國 |	CONCACAF member associations map.svg
國家隊賽事

CONCACAF官方賽事
賽事中文名稱	賽事官方名稱	賽事簡介
  美洲金盃	CONCACAF Gold Cup	於1991年舉行首屆賽事，每兩年舉辦一屆。
  中北美洲及加勒比海國家聯賽	CONCACAF Nations League	於2018年舉行首屆賽事，每兩年舉辦一屆。
  中美洲國家盃	Copa Centroamericana	於1991年舉行首屆賽事，每兩年舉辦一屆，參賽國家只有伯利茲、哥斯達黎加、薩爾瓦多、危地馬拉、洪都拉斯、尼加拉瓜及巴拿馬中美洲國家參加。
  加勒比海盃	Caribbean Cup	於1989年舉行首屆賽事，每兩年舉辦一屆，參賽國家為加勒比海足球聯盟31個成員國參加。
  加勒比海足球錦標賽	CFU Championship	曾經於1978年至1988年舉辦，參賽國家為加勒比海足球聯盟31個成員國參加。
  CONCACAF錦標賽	CONCACAF Championship	曾經於1963年至1989年舉辦，1991年賽事由美洲金盃取代。
  北美足球錦標賽	NAFC Championship	曾經於1947年至1981年舉辦，1991年賽事由美洲金盃取代。
  中美洲足球錦標賽	CCCF Championship	曾經於1947年至1981年舉辦，參賽國家為中美洲及加勒比海足球聯盟31個成員國參加。
球會賽事

CONCACAF官方賽事
賽事中文名稱	賽事官方名稱	賽事簡介
  CONCACAF冠軍盃	CONCACAF Champions' Cup	於1962年舉行首屆賽事，每年舉辦一屆。
  加勒比球會冠軍盃	CFU Club Championship	於1997年舉行首屆賽事，每年舉辦一屆。
  北美超級聯賽	North American SuperLiga	曾經於2007年至2010年舉辦四屆賽事，參賽球隊包括來自墨西哥及美國職業足球大聯盟。
  CONCACAF盃賽冠軍盃	CONCACAF Cup Winners Cup	曾經於1991年至1998年舉辦八屆賽事。
  CONCACAF巨人盃	CONCACAF Giants Cup	曾經於2001年舉辦一屆賽事。
  中美洲球會冠軍盃	Copa Interclubes UNCAF	曾經於1971年至2007年，每年舉辦一屆。
安圭拉 安圭拉
賽事中文名稱	賽事官方名稱	賽事性質	賽事簡介
  安圭拉足球聯賽	Anguillan League	國內頂級聯賽	於1997年舉行首屆賽事。
加拿大 加拿大
賽事中文名稱	賽事官方名稱	賽事性質	賽事簡介
  美國職業足球大聯盟	Major League Soccer	國內頂級聯賽	於1996年舉行首屆賽事，同時也是美國國內最高級別聯賽。
  北美足球聯賽	North American Soccer League	國內第二級聯賽	於2009年舉行首屆賽事，同時也是美國國內第二高級別聯賽。
  加拿大足球聯賽	Canadian Soccer League	國內第三級聯賽	於2006年舉行首屆賽事。
哥斯达黎加 哥斯達黎加
賽事中文名稱	賽事官方名稱	賽事性質	賽事簡介
  哥斯達黎加足球甲級聯賽	Primera División de Costa Rica	國內頂級聯賽	於1921年舉行首屆賽事。
墨西哥 墨西哥
賽事中文名稱	賽事官方名稱	賽事性質	賽事簡介
  墨西哥足球超級聯賽	Liga MX	國內頂級聯賽	於1943年舉行首屆賽事。
  墨西哥足球升級聯賽	Ascenso MX	國內第二級聯賽	於1994年舉行首屆賽事。
  墨西哥足球乙级联赛	Segunda División de México	國內第三級聯賽	於1950年舉行首屆賽事。
  墨西哥足球丙级联赛	Tercera División de México	國內第四級聯賽	於1967年舉行首屆賽事。
美國 美國
賽事中文名稱	賽事官方名稱	賽事性質	賽事簡介
  美國職業足球大聯盟	Major League Soccer	國內頂級聯賽	於1996年舉行首屆賽事，同時也是加拿大國內最高級別聯賽。
  北美足球聯賽	North American Soccer League	國內第二級聯賽	於2009年舉行首屆賽事，同時也是加拿大國內第二高級別聯賽。
  美國足球聯盟專業聯賽	USL Professional Division	國內第三級聯賽	於2010年舉行首屆賽事。
  美國足球聯盟發展聯賽	USL Premier Development League	國內第四級聯賽	於1986年舉行首屆賽事。
  國家超級足球聯賽	National Premier Soccer League	國內第四級聯賽	於1986年舉行首屆賽事。
  美國公開盃	Lamar Hunt U.S. Open Cup	全國性盃賽	於1914年舉行首屆賽事。
  美国足球大联盟杯	MLS Cup	全國性盃賽	於1994年舉行首屆賽事，是美國職業足球大聯盟決賽中獲勝球隊獲得的，官方認可的聯賽冠軍。
  美國女子足球職業聯賽	Women's Professional Soccer	國內頂級聯賽	於2007年舉行首屆賽事，於2012年宣布解散。
OFC （大洋洲區賽事）
美屬薩摩亞 | 庫克群島 | 斐濟 | 新喀里多尼亞 | 紐西蘭 | 巴布亞紐幾內亞 | 薩摩亞 | 所羅門群島 | 塔希提 | 湯加 | 萬那杜	Oceania Football Confederation member associations map.svg
國家隊賽事

OFC官方賽事
賽事中文名稱	賽事官方名稱	賽事簡介
  大洋洲國家盃	Oceania Nations Cup	於1973年舉行首屆賽事，每四年舉辦一屆。
  奧運會足球比賽大洋洲區預賽	OFC Olympic Qualifying Tournament	於1992年舉行首屆賽事，每四年舉辦一屆。
  大洋洲運動會足球比賽	Pacific Games	於1963年舉行首屆賽事，每四年舉辦一屆。
  大洋洲U-20錦標賽	OFC U-20 Championship	於1974年舉行首屆賽事，不定期舉辦一屆，參賽球員年齡不得超過20歲，亦是世青盃大洋洲區預賽。
  大洋洲U-17錦標賽	OFC U-17 Championship	於1983年舉行首屆賽事，每兩年舉辦一屆，參賽球員年齡不得超過17歲，亦是世少盃大洋洲區預賽。
  大洋洲女子足球锦标赛	OFC Women's Championship	於1983年舉行首屆賽事，每四年舉辦一屆。
  奧運會女子足球比賽大洋洲區預賽	OFC Women's Olympic Qualifying Tournament	於2004年舉行首屆賽事，每四年舉辦一屆。
  U20女子世界盃大洋洲區預賽	OFC Women's U-20 Qualifying Tournament	於2004年舉行首屆賽事，每兩年舉辦一屆，參賽球員年齡不得超過20歲。
  U17女子世界盃大洋洲區預賽	OFC Women's U-17 Qualifying Tournament	於2010年舉行首屆賽事，每兩年舉辦一屆，參賽球員年齡不得超過17歲。
  大洋洲室内足球錦標賽	Oceanian Futsal Championship	於1992年舉行首屆賽事，每年舉辦一屆。
  大洋洲沙灘足球錦標賽	OFC Beach Soccer Championship	於2006年舉行首屆賽事，每兩年舉辦一屆，亦是國際足協沙灘足球世界盃大洋洲區預賽。
  亞洲–大洋洲挑戰盃	AFC–OFC Challenge Cup	曾經於2001年及2003年舉辦，每年舉辦一屆，是一項由亞洲冠軍及大洋洲冠軍對抗的錦標賽。
  波利尼西亞盃	Polynesia Cup	曾經於1994年至2000年舉辦，不定期舉辦一屆，是一項由波利尼西亞地區的國家對抗的錦標賽。
  美拉尼西亞盃	Melanesia Cup	曾經於1988年至2000年舉辦，每兩年舉辦一屆，是一項由美拉尼西亞地區的國家對抗的錦標賽。
球會賽事

OFC官方賽事
賽事中文名稱	賽事官方名稱	賽事簡介
  大洋洲聯賽冠軍盃	OFC Champions League	於1987年舉行首屆賽事，每年舉辦一屆。
美屬薩摩亞 美屬薩摩亞
賽事中文名稱	賽事官方名稱	賽事性質	賽事簡介
  美属萨摩亚高级联赛	FFAS Senior League	國內頂級聯賽	於1981年舉行首屆賽事。
斐濟 斐济
賽事中文名稱	賽事官方名稱	賽事性質	賽事簡介
  斐济全国足球联赛	National Football League	國內頂級聯賽	於1997年舉行首屆賽事。
新西兰 紐西蘭
賽事中文名稱	賽事官方名稱	賽事性質	賽事簡介
  新西兰足球锦标赛	New Zealand Football Championship	國內頂級聯賽	於2004年舉行首屆賽事。
  新西蘭北部超級聯賽	Northern Region Football League Premier	國內第二級聯賽	於1965年舉行首屆賽事。
  新西蘭北部甲組聯賽	Northern Region Football League Division 1	國內第三級聯賽	於1965年舉行首屆賽事。
  新西蘭北部乙組聯賽	Northern Region Football League Division 2	國內第四級聯賽	於1965年舉行首屆賽事。
  查塔姆盃	Chatham Cup	全國性盃賽	於1923年舉行首屆賽事，賽事只給予新西兰足球锦标赛以外的球隊參加。
巴布亚新几内亚 巴布亚新几内亚
賽事中文名稱	賽事官方名稱	賽事性質	賽事簡介
  巴布亚新几内亚全国足球联赛	Papua New Guinea National Soccer League	國內頂級聯賽	於2006年舉行首屆賽事。
法屬玻里尼西亞 塔希提
賽事中文名稱	賽事官方名稱	賽事性質	賽事簡介
  塔希提足球甲级联赛	Tahiti First Division	國內頂級聯賽	於1948年舉行首屆賽事。
東加 汤加
賽事中文名稱	賽事官方名稱	賽事性質	賽事簡介
  汤加足球大联盟	Tonga Major League	國內頂級聯賽	於1969年舉行首屆賽事。
CAF （非洲區賽事）
阿爾及利亞 | 安哥拉 | 貝寧 | 博茨瓦納 | 布基納法索 | 布隆迪 | 喀麥隆 | 佛得角 | 中非 | 乍得 | 科摩羅 | 剛果共和國 | 剛果民主共和國 | 科特迪瓦 | 吉布提 | 埃及 | 赤道幾內亞 | 厄立特里亞 | 埃塞俄比亞 | 加蓬 | 岡比亞 | 加納 | 幾內亞 | 幾內亞比紹 | 肯尼亞 | 萊索托 | 利比里亞 | 利比亞 | 馬達加斯加 | 馬拉維 | 馬里 | 毛里塔尼亞 | 毛里求斯 | 摩洛哥 | 莫桑比克 | 納米比亞 | 尼日爾 | 尼日利亞 | 盧旺達 | 聖多美和普林西比 | 塞內加爾 | 塞舌爾 | 塞拉利昂 | 索馬里 | 南非 | 蘇丹 | 斯威士蘭 | 坦桑尼亞 | 多哥 | 突尼斯 | 烏干達 | 贊比亞 | 津巴布韋 	Confederation of African Football member associations map.svg
國家隊賽事

CAF官方賽事
賽事中文名稱	賽事官方名稱	賽事簡介
  非洲國家盃	African Nations Cup	於1957年舉行首屆賽事，每兩年舉辦一屆。
  非洲國家足球錦標賽	African Nations Championship	於2009年舉行首屆賽事，每兩年舉辦一屆，參賽球員只限效力國內球會。
  全非運動會足球比賽	All-Africa Games	於1965年舉行首屆賽事，每四年舉辦一屆，參賽球員年齡不得超過23歲。
  非洲U-23足球錦標賽	CAF U-23 Championship	於2011年舉行首屆賽事，每四年舉辦一屆，參賽球員年齡不得超過23歲。
  非洲少年足球錦標賽	African Youth Championship	於1979年舉行首屆賽事，每兩年舉辦一屆，參賽球員年齡不得超過20歲。
  非洲U-17足球錦標賽	CAF U-17 Championship	於1995年舉行首屆賽事，每兩年舉辦一屆，參賽球員年齡不得超過17歲。
  非洲女子足球錦標赛	African Women's Championship	於1991年舉行首屆賽事，每兩年舉辦一屆。
  非洲女子U20國家盃	African U-20 Cup of Nations for Women	於2002年舉行首屆賽事，每兩年舉辦一屆，參賽球員年齡不得超過20歲。
  非洲女子U17國家盃	African U-17 Cup of Nations for Women	於2008年舉行首屆賽事，每兩年舉辦一屆，參賽球員年齡不得超過17歲。
  非洲室內足球錦標赛	African Futsal Championship	於1996年舉行首屆賽事，每四年舉辦一屆。
  非洲沙灘足球錦標赛	CAF Beach Soccer Championship	於2006年舉行首屆賽事，每兩年舉辦一屆，2011年後改為FIFA沙灘足球世界盃非洲區預賽。
球會賽事

CAF官方賽事
賽事中文名稱	賽事官方名稱	賽事簡介
  非洲聯賽冠軍盃	CAF Champions League	於1964年舉行首屆賽事，每年舉辦一屆。
  非洲足協盃	CAF Confederation Cup	於2004年舉行首屆賽事，每年舉辦一屆。
  非洲超級盃	CAF Super Cup	於1993年舉行首屆賽事，每年舉辦一屆。
  CAF盃	CAF Cup	曾經於1992年至2004年舉辦，每年舉辦一屆。
  非洲盃賽冠軍盃	African Cup Winners' Cup	曾經於1975年至2004年舉辦，每年舉辦一屆。
阿尔及利亚 阿爾及利亞
賽事中文名稱	賽事官方名稱	賽事性質	賽事簡介
  阿爾及利亞甲組足球聯賽	Algerian Ligue Professionnelle 1	國內頂級聯賽	於1962年舉行首屆賽事。
  阿爾及利亞乙組足球聯賽	Algerian Ligue Professionnelle 2	國內第二級聯賽	於1962年舉行首屆賽事。
  阿爾及利亞盃	Algerian Cup	全國性盃賽	於1962年舉行首屆賽事。
  阿爾及利亞超级杯	Algerian Super Cup	超級盃	於1991年舉行首屆賽事，是由甲組聯賽冠軍及阿爾及利亞盃冠軍對抗的錦標賽。
安哥拉 安哥拉
賽事中文名稱	賽事官方名稱	賽事性質	賽事簡介
  安哥拉足球甲级联赛	Girabola	國內頂級聯賽	於1979年舉行首屆賽事。
  安哥拉足球乙级联赛	Gira Angola	國內第二級聯賽	於2008年舉行首屆賽事。
  安哥拉盃	Taça de Angola	全國性盃賽	於1982年舉行首屆賽事。
  安哥拉超级杯	SuperTaça de Angola	超級盃	於1988年舉行首屆賽事，是由甲組聯賽冠軍及安哥拉盃冠軍對抗的錦標賽。
贝宁 貝寧
賽事中文名稱	賽事官方名稱	賽事性質	賽事簡介
  貝寧超級足球聯賽	Benin Premier League	國內頂級聯賽	於1969年舉行首屆賽事。
  貝寧盃	Benin Cup	全國性盃賽	於1974年舉行首屆賽事。
波札那 博茨瓦納
賽事中文名稱	賽事官方名稱	賽事性質	賽事簡介
  博茨瓦納超級足球聯賽	Botswana Premier League	國內頂級聯賽	於1966年舉行首屆賽事。
  博茨瓦納足總盃	FA Challenge Cup	全國性盃賽	於1968年舉行首屆賽事。
布吉納法索 布基纳法索
賽事中文名稱	賽事官方名稱	賽事性質	賽事簡介
  布基纳法索超級足球聯賽	Burkinabé Premier League	國內頂級聯賽	於1961年舉行首屆賽事。
  布基纳法索盃	Coupe du Faso	全國性盃賽	於1961年舉行首屆賽事。
  布基纳法索超級盃	Burkinabé SuperCup	超級盃	於1992年舉行首屆賽事。
蒲隆地 布隆迪
賽事中文名稱	賽事官方名稱	賽事性質	賽事簡介
  布隆迪超級足球聯賽	Burundi Premier League	國內頂級聯賽	於1972年舉行首屆賽事。
  布隆迪盃	Burundian Cup	全國性盃賽	於1982年舉行首屆賽事。
喀麦隆 喀麥隆
賽事中文名稱	賽事官方名稱	賽事性質	賽事簡介
  喀麦隆足球甲级联赛	Championnat du Cameroun de football	國內頂級聯賽	於1961年舉行首屆賽事。
  喀麥隆盃	Cameroonian Cup	全國性盃賽	於1941年舉行首屆賽事。
  羅渣米拿超級盃	Super Coupe Roger Milla	超級盃	於1999年舉行首屆賽事，只舉行過四屆。
佛得角 佛得角
賽事中文名稱	賽事官方名稱	賽事性質	賽事簡介
  佛得角國家錦標賽	Cape Verdean Championships	國內頂級聯賽	於1976年舉行首屆賽事。
  佛得角盃	Taça Nacional de Cabo Verde	全國性盃賽	於2007年舉行首屆賽事。
乍得 乍得
賽事中文名稱	賽事官方名稱	賽事性質	賽事簡介
  乍得超級足球聯賽	Chad Premier League	國內頂級聯賽	於1988年舉行首屆賽事。
  乍得盃	Chad Cup	全國性盃賽	於1973年舉行首屆賽事。
中非共和國 中非共和國
賽事中文名稱	賽事官方名稱	賽事性質	賽事簡介
  中非共和國足球聯賽	Central African Republic League	國內頂級聯賽	於1968年舉行首屆賽事。
  中非共和國盃	Central African Republic Coupe Nationale	全國性盃賽	於1974年舉行首屆賽事。
葛摩 科摩羅
賽事中文名稱	賽事官方名稱	賽事性質	賽事簡介
  科摩羅超級足球聯賽	Comoros Premier League	國內頂級聯賽	於1979年舉行首屆賽事。
  科摩羅盃	Comoros Cup	全國性盃賽	於1982年舉行首屆賽事。
刚果共和国 剛果共和國
賽事中文名稱	賽事官方名稱	賽事性質	賽事簡介
  剛果共和國超級足球聯賽	Congo Premier League	國內頂級聯賽	於1961年舉行首屆賽事。
  剛果共和國盃	Coupe du Congo de football	全國性盃賽	於1974年舉行首屆賽事。
刚果民主共和国 剛果民主共和國
賽事中文名稱	賽事官方名稱	賽事性質	賽事簡介
  刚果民主共和国足球甲级联赛	Linafoot	國內頂級聯賽	於1958年舉行首屆賽事。
  剛果民主共和國盃	Coupe du Congo	全國性盃賽	於1961年舉行首屆賽事。
科特迪瓦 科特迪瓦
賽事中文名稱	賽事官方名稱	賽事性質	賽事簡介
  科特迪瓦足球甲級聯賽	Ligue 1	國內頂級聯賽	於1960年舉行首屆賽事。
  科特迪瓦盃	Coupe de Côte d'Ivoire de football	全國性盃賽	於1960年舉行首屆賽事。
吉布提 吉布提
賽事中文名稱	賽事官方名稱	賽事性質	賽事簡介
  吉布提超級足球聯賽	Djibouti Premier League	國內頂級聯賽	於1987年舉行首屆賽事。
  吉布提盃	Djibouti Cup	全國性盃賽	於1988年舉行首屆賽事。
埃及 埃及
賽事中文名稱	賽事官方名稱	賽事性質	賽事簡介
  埃及足球甲级联赛	Egyptian Premier League	國內頂級聯賽	於1948年舉行首屆賽事。
  埃及盃	Egypt Cup	全國性盃賽	於1922年舉行首屆賽事。
赤道几内亚 赤道畿內亞
賽事中文名稱	賽事官方名稱	賽事性質	賽事簡介
  赤道畿內亞超級足球聯賽	Equatoguinean Premier League	國內頂級聯賽	於1979年舉行首屆賽事。
  赤道畿內亞盃	Equatoguinean Cup	全國性盃賽	於1974年舉行首屆賽事。
摩洛哥 摩洛哥
賽事中文名稱	賽事官方名稱	賽事性質	賽事簡介
  摩洛哥足球甲級聯賽	Botola Pro 1	國內頂級聯賽	於1956年舉行首屆賽事。
  摩洛哥足球乙級聯賽	Botola 2	國內第二級聯賽	於1956年舉行首屆賽事。
備註
参看
国家足球队列表
足球运动员列表
足球俱乐部列表
分类：足球競賽足球相關列表體育事件列表
导航菜单
没有登录
讨论
贡献
创建账户
登录
条目讨论不转换
汉漢
阅读编辑查看历史搜索
搜索维基百科
首页
分类索引
特色内容
新闻动态
最近更改
随机条目
资助维基百科
帮助
帮助
维基社群
方针与指引
互助客栈
知识问答
字词转换
IRC即时聊天
联络我们
关于维基百科
工具
链入页面
相关更改
上传文件
特殊页面
固定链接
页面信息
引用本页
维基数据项
短链接
打印/导出
下载为PDF
打印页面

其他语言
English
Tiếng Việt
编辑链接

本页面最后修订于2021年3月31日 (星期三) 17:30。
本站的全部文字在知识共享 署名-相同方式共享 3.0协议之条款下提供，附加条款亦可能应用。（请参阅使用条款）
Wikipedia®和维基百科标志是维基媒体基金会的注册商标；维基™是维基媒体基金会的商标。
维基媒体基金会是按美国国內稅收法501(c)(3)登记的非营利慈善机构。
隐私政策关于维基百科免责声明手机版视图开发者统计Cookie声明Wikimedia FoundationPowered by MediaWiki